Datetime,Buy_Count,Sell_Count,Short Position,Long Position,Price,
2021-10-29 14:30:00+01:00,0,0,0,0,15693.59,0
2021-10-29 15:30:00+01:00,0,0,0,0,15746.69,0
2021-10-29 16:30:00+01:00,0,0,0,0,15804.11,0
2021-10-29 17:30:00+01:00,0,0,0,0,15812.09,0
2021-10-29 18:30:00+01:00,0,0,0,0,15778.54,0
2021-10-29 19:30:00+01:00,0,0,0,0,15794.39,0
2021-10-29 20:30:00+01:00,0,0,0,0,15848.17,0
2021-11-01 13:30:00+00:00,0,0,0,0,15830.69,0
2021-11-01 14:30:00+00:00,0,0,0,0,15858.64,0
2021-11-01 15:30:00+00:00,0,0,0,0,15868.33,0
2021-11-01 16:30:00+00:00,0,0,0,0,15848.64,0
2021-11-01 17:30:00+00:00,0,0,0,0,15820.09,0
2021-11-01 18:30:00+00:00,0,0,0,0,15862.59,0
2021-11-01 19:30:00+00:00,3,30,0,27,15907.48,27
2021-11-02 13:30:00+00:00,1,25,0,24,15959.22,24
2021-11-02 14:30:00+00:00,3,24,0,21,15965.53,21
2021-11-02 15:30:00+00:00,2,19,0,17,15951.66,17
2021-11-02 16:30:00+00:00,5,20,0,15,15945.34,15
2021-11-02 17:30:00+00:00,3,21,0,18,15931.27,18
2021-11-02 18:30:00+00:00,2,23,0,21,15964.72,21
2021-11-02 19:30:00+00:00,5,23,0,18,15973.70,18
2021-11-03 13:30:00+00:00,2,23,0,21,15969.19,21
2021-11-03 14:30:00+00:00,3,21,0,18,15974.48,18
2021-11-03 15:30:00+00:00,2,21,0,19,15990.90,19
2021-11-03 16:30:00+00:00,3,27,0,24,15990.55,24
2021-11-03 17:30:00+00:00,4,31,0,27,16026.01,27
2021-11-03 18:30:00+00:00,2,31,0,29,16110.44,29
2021-11-03 19:30:00+00:00,0,32,0,32,16143.13,32
2021-11-04 13:30:00+00:00,1,37,0,36,16306.80,36
2021-11-04 14:30:00+00:00,3,25,0,22,16260.13,22
2021-11-04 15:30:00+00:00,3,33,0,30,16314.11,30
2021-11-04 16:30:00+00:00,4,36,0,32,16326.51,32
2021-11-04 17:30:00+00:00,6,35,0,29,16369.14,29
2021-11-04 18:30:00+00:00,5,29,0,24,16340.08,24
2021-11-04 19:30:00+00:00,4,30,0,26,16347.31,26
2021-11-05 13:30:00+00:00,7,49,0,42,16427.97,42
2021-11-05 14:30:00+00:00,8,42,0,34,16417.91,34
2021-11-05 15:30:00+00:00,8,41,0,33,16427.62,33
2021-11-05 16:30:00+00:00,10,32,0,22,16304.61,22
2021-11-05 17:30:00+00:00,6,34,0,28,16370.91,28
2021-11-05 18:30:00+00:00,8,27,0,19,16353.11,19
2021-11-05 19:30:00+00:00,7,25,0,18,16354.70,18
2021-11-08 14:30:00+00:00,12,16,0,4,16351.02,4
2021-11-08 15:30:00+00:00,11,24,0,13,16370.76,13
2021-11-08 16:30:00+00:00,16,21,0,5,16336.02,5
2021-11-08 17:30:00+00:00,12,19,0,7,16370.67,7
2021-11-08 18:30:00+00:00,9,16,0,7,16352.05,7
2021-11-08 19:30:00+00:00,10,16,0,6,16359.41,6
2021-11-08 20:30:00+00:00,12,15,0,3,16334.94,3
2021-11-09 14:30:00+00:00,12,8,4,0,16248.28,-4
2021-11-09 15:30:00+00:00,16,10,6,0,16244.32,-6
2021-11-09 16:30:00+00:00,14,10,4,0,16215.69,-4
2021-11-09 17:30:00+00:00,12,15,0,3,16200.29,3
2021-11-09 18:30:00+00:00,14,12,2,0,16219.18,-2
2021-11-09 19:30:00+00:00,11,10,1,0,16201.12,-1
2021-11-09 20:30:00+00:00,12,11,1,0,16222.00,-1
2021-11-10 14:30:00+00:00,12,11,1,0,16187.75,-1
2021-11-10 15:30:00+00:00,18,15,3,0,16156.15,-3
2021-11-10 16:30:00+00:00,17,17,0,0,16129.98,0
2021-11-10 17:30:00+00:00,27,13,14,0,16061.68,-14
2021-11-10 18:30:00+00:00,35,12,23,0,15945.00,-23
2021-11-10 19:30:00+00:00,33,8,25,0,15988.82,-25
2021-11-10 20:30:00+00:00,35,6,29,0,15984.09,-29
2021-11-11 14:30:00+00:00,17,5,12,0,16058.30,-12
2021-11-11 15:30:00+00:00,19,8,11,0,16079.48,-11
2021-11-11 16:30:00+00:00,21,6,15,0,16047.74,-15
2021-11-11 17:30:00+00:00,21,7,14,0,16050.95,-14
2021-11-11 18:30:00+00:00,19,8,11,0,16067.38,-11
2021-11-11 19:30:00+00:00,24,8,16,0,16038.40,-16
2021-11-11 20:30:00+00:00,26,6,20,0,16031.53,-20
2021-11-12 14:30:00+00:00,21,8,13,0,16070.62,-13
2021-11-12 15:30:00+00:00,10,15,0,5,16186.37,5
2021-11-12 16:30:00+00:00,10,17,0,7,16194.83,7
2021-11-12 17:30:00+00:00,10,26,0,16,16182.86,16
2021-11-12 18:30:00+00:00,11,38,0,27,16177.75,27
2021-11-12 19:30:00+00:00,9,40,0,31,16202.29,31
2021-11-12 20:30:00+00:00,7,38,0,31,16200.83,31
2021-11-15 14:30:00+00:00,6,28,0,22,16168.92,22
2021-11-15 15:30:00+00:00,6,25,0,19,16170.66,19
2021-11-15 16:30:00+00:00,5,14,0,9,16111.73,9
2021-11-15 17:30:00+00:00,5,23,0,18,16152.33,18
2021-11-15 18:30:00+00:00,5,19,0,14,16139.73,14
2021-11-15 19:30:00+00:00,5,25,0,20,16198.07,20
2021-11-15 20:30:00+00:00,4,27,0,23,16192.82,23
2021-11-16 14:30:00+00:00,4,22,0,18,16208.94,18
2021-11-16 15:30:00+00:00,6,19,0,13,16301.60,13
2021-11-16 16:30:00+00:00,5,16,0,11,16296.60,11
2021-11-16 17:30:00+00:00,7,16,0,9,16296.85,9
2021-11-16 18:30:00+00:00,6,15,0,9,16319.14,9
2021-11-16 19:30:00+00:00,6,14,0,8,16310.53,8
2021-11-16 20:30:00+00:00,6,17,0,11,16308.28,11
2021-11-17 14:30:00+00:00,10,14,0,4,16318.02,4
2021-11-17 15:30:00+00:00,10,14,0,4,16357.11,4
2021-11-17 16:30:00+00:00,10,20,0,10,16314.15,10
2021-11-17 17:30:00+00:00,10,23,0,13,16329.84,13
2021-11-17 18:30:00+00:00,11,21,0,10,16339.03,10
2021-11-17 19:30:00+00:00,8,17,0,9,16314.90,9
2021-11-17 20:30:00+00:00,10,14,0,4,16307.32,4
2021-11-18 14:30:00+00:00,19,9,10,0,16335.31,-10
2021-11-18 15:30:00+00:00,20,11,9,0,16390.74,-9
2021-11-18 16:30:00+00:00,13,14,0,1,16488.94,1
2021-11-18 17:30:00+00:00,15,14,1,0,16442.71,-1
2021-11-18 18:30:00+00:00,15,6,9,0,16427.49,-9
2021-11-18 19:30:00+00:00,14,7,7,0,16473.83,-7
2021-11-18 20:30:00+00:00,12,8,4,0,16483.96,-4
2021-11-19 14:30:00+00:00,15,15,0,0,16555.01,0
2021-11-19 15:30:00+00:00,13,15,0,2,16606.07,2
2021-11-19 16:30:00+00:00,13,23,0,10,16609.22,10
2021-11-19 17:30:00+00:00,18,16,2,0,16559.20,-2
2021-11-19 18:30:00+00:00,16,16,0,0,16580.97,0
2021-11-19 19:30:00+00:00,19,15,4,0,16578.42,-4
2021-11-19 20:30:00+00:00,19,17,2,0,16574.46,-2
2021-11-22 14:30:00+00:00,14,34,0,20,16738.43,20
2021-11-22 15:30:00+00:00,26,23,3,0,16612.07,-3
2021-11-22 16:30:00+00:00,24,15,9,0,16509.09,-9
2021-11-22 17:30:00+00:00,24,13,11,0,16541.74,-11
2021-11-22 18:30:00+00:00,24,9,15,0,16534.91,-15
2021-11-22 19:30:00+00:00,23,12,11,0,16550.98,-11
2021-11-22 20:30:00+00:00,29,7,22,0,16377.41,-22
2021-11-23 14:30:00+00:00,35,6,29,0,16246.10,-29
2021-11-23 15:30:00+00:00,39,9,30,0,16249.19,-30
2021-11-23 16:30:00+00:00,37,6,31,0,16223.28,-31
2021-11-23 17:30:00+00:00,37,7,30,0,16152.45,-30
2021-11-23 18:30:00+00:00,33,6,27,0,16167.33,-27
2021-11-23 19:30:00+00:00,32,6,26,0,16248.48,-26
2021-11-23 20:30:00+00:00,24,8,16,0,16310.98,-16
2021-11-24 14:30:00+00:00,33,1,32,0,16251.68,-32
2021-11-24 15:30:00+00:00,19,0,19,0,16317.59,-19
2021-11-24 16:30:00+00:00,16,1,15,0,16285.13,-15
2021-11-24 17:30:00+00:00,13,2,11,0,16327.60,-11
2021-11-24 18:30:00+00:00,16,1,15,0,16284.21,-15
2021-11-24 19:30:00+00:00,11,2,9,0,16357.94,-9
2021-11-24 20:30:00+00:00,5,7,0,2,16370.56,2
2021-11-26 14:30:00+00:00,8,11,0,3,16175.65,3
2021-11-26 15:30:00+00:00,19,5,14,0,16075.92,-14
2021-11-26 16:30:00+00:00,15,6,9,0,16120.63,-9
2021-11-29 14:30:00+00:00,8,6,2,0,16270.20,-2
2021-11-29 15:30:00+00:00,8,8,0,0,16293.59,0
2021-11-29 16:30:00+00:00,7,9,0,2,16385.58,2
2021-11-29 17:30:00+00:00,5,9,0,4,16402.48,4
2021-11-29 18:30:00+00:00,8,12,0,4,16399.73,4
2021-11-29 19:30:00+00:00,9,13,0,4,16419.79,4
2021-11-29 20:30:00+00:00,8,10,0,2,16396.05,2
2021-11-30 14:30:00+00:00,16,8,8,0,16413.10,-8
2021-11-30 15:30:00+00:00,18,1,17,0,16174.84,-17
2021-11-30 16:30:00+00:00,26,1,25,0,16140.22,-25
2021-11-30 17:30:00+00:00,26,1,25,0,16134.16,-25
2021-11-30 18:30:00+00:00,12,3,9,0,16199.71,-9
2021-11-30 19:30:00+00:00,12,5,7,0,16122.42,-7
2021-11-30 20:30:00+00:00,22,4,18,0,16143.68,-18
2021-12-01 14:30:00+00:00,18,8,10,0,16315.35,-10
2021-12-01 15:30:00+00:00,17,10,7,0,16410.79,-7
2021-12-01 16:30:00+00:00,22,6,16,0,16330.68,-16
2021-12-01 17:30:00+00:00,27,2,25,0,16252.78,-25
2021-12-01 18:30:00+00:00,29,2,27,0,16187.34,-27
2021-12-01 19:30:00+00:00,47,0,47,0,15986.76,-47
2021-12-01 20:30:00+00:00,50,1,49,0,15864.44,-49
2021-12-02 14:30:00+00:00,27,0,27,0,15908.79,-27
2021-12-02 15:30:00+00:00,18,1,17,0,15961.29,-17
2021-12-02 16:30:00+00:00,11,1,10,0,16048.91,-10
2021-12-02 17:30:00+00:00,14,1,13,0,15946.34,-13
2021-12-02 18:30:00+00:00,11,1,10,0,16020.78,-10
2021-12-02 19:30:00+00:00,10,1,9,0,15992.04,-9
2021-12-02 20:30:00+00:00,12,1,11,0,15991.30,-11
2021-12-03 14:30:00+00:00,32,1,31,0,15810.25,-31
2021-12-03 15:30:00+00:00,39,1,38,0,15711.42,-38
2021-12-03 16:30:00+00:00,35,1,34,0,15647.26,-34
2021-12-03 17:30:00+00:00,30,1,29,0,15650.63,-29
2021-12-03 18:30:00+00:00,29,2,27,0,15622.05,-27
2021-12-03 19:30:00+00:00,25,4,21,0,15613.79,-21
2021-12-03 20:30:00+00:00,14,16,0,2,15715.91,2
2021-12-06 14:30:00+00:00,17,16,1,0,15763.29,-1
2021-12-06 15:30:00+00:00,22,13,9,0,15708.07,-9
2021-12-06 16:30:00+00:00,22,11,11,0,15783.54,-11
2021-12-06 17:30:00+00:00,12,16,0,4,15871.80,4
2021-12-06 18:30:00+00:00,15,11,4,0,15885.19,-4
2021-12-06 19:30:00+00:00,14,12,2,0,15855.58,-2
2021-12-06 20:30:00+00:00,15,11,4,0,15843.24,-4
2021-12-07 14:30:00+00:00,1,39,0,38,16238.52,38
2021-12-07 15:30:00+00:00,1,54,0,53,16277.19,53
2021-12-07 16:30:00+00:00,1,57,0,56,16308.92,56
2021-12-07 17:30:00+00:00,1,58,0,57,16314.84,57
2021-12-07 18:30:00+00:00,1,67,0,66,16320.50,66
2021-12-07 19:30:00+00:00,1,62,0,61,16268.64,61
2021-12-07 20:30:00+00:00,1,58,0,57,16324.00,57
2021-12-08 14:30:00+00:00,3,41,0,38,16294.69,38
2021-12-08 15:30:00+00:00,4,54,0,50,16320.82,50
2021-12-08 16:30:00+00:00,4,53,0,49,16307.16,49
2021-12-08 17:30:00+00:00,1,48,0,47,16345.46,47
2021-12-08 18:30:00+00:00,1,42,0,41,16354.76,41
2021-12-08 19:30:00+00:00,1,54,0,53,16372.05,53
2021-12-08 20:30:00+00:00,1,60,0,59,16393.91,59
2021-12-09 14:30:00+00:00,8,13,0,5,16277.93,5
2021-12-09 15:30:00+00:00,9,14,0,5,16335.72,5
2021-12-09 16:30:00+00:00,9,7,2,0,16279.83,-2
2021-12-09 17:30:00+00:00,9,5,4,0,16270.90,-4
2021-12-09 18:30:00+00:00,12,6,6,0,16238.69,-6
2021-12-09 19:30:00+00:00,10,3,7,0,16171.67,-7
2021-12-09 20:30:00+00:00,17,1,16,0,16151.06,-16
2021-12-10 14:30:00+00:00,10,9,1,0,16291.08,-1
2021-12-10 15:30:00+00:00,23,9,14,0,16211.29,-14
2021-12-10 16:30:00+00:00,21,10,11,0,16244.72,-11
2021-12-10 17:30:00+00:00,23,10,13,0,16270.68,-13
2021-12-10 18:30:00+00:00,23,10,13,0,16263.06,-13
2021-12-10 19:30:00+00:00,30,8,22,0,16272.62,-22
2021-12-10 20:30:00+00:00,28,10,18,0,16329.48,-18
2021-12-13 14:30:00+00:00,24,10,14,0,16216.43,-14
2021-12-13 15:30:00+00:00,32,8,24,0,16156.68,-24
2021-12-13 16:30:00+00:00,29,10,19,0,16174.29,-19
2021-12-13 17:30:00+00:00,25,9,16,0,16149.75,-16
2021-12-13 18:30:00+00:00,18,9,9,0,16174.02,-9
2021-12-13 19:30:00+00:00,13,18,0,5,16156.13,5
2021-12-13 20:30:00+00:00,15,18,0,3,16085.30,3
2021-12-14 14:30:00+00:00,34,3,31,0,15921.88,-31
2021-12-14 15:30:00+00:00,39,6,33,0,15816.41,-33
2021-12-14 16:30:00+00:00,43,3,40,0,15772.72,-40
2021-12-14 17:30:00+00:00,50,2,48,0,15792.97,-48
2021-12-14 18:30:00+00:00,44,5,39,0,15834.49,-39
2021-12-14 19:30:00+00:00,27,6,21,0,15942.25,-21
2021-12-14 20:30:00+00:00,38,5,33,0,15922.13,-33
2021-12-15 14:30:00+00:00,32,4,28,0,15857.88,-28
2021-12-15 15:30:00+00:00,30,4,26,0,15816.89,-26
2021-12-15 16:30:00+00:00,34,4,30,0,15792.34,-30
2021-12-15 17:30:00+00:00,31,2,29,0,15807.53,-29
2021-12-15 18:30:00+00:00,19,3,16,0,15918.55,-16
2021-12-15 19:30:00+00:00,2,8,0,6,16205.85,6
2021-12-15 20:30:00+00:00,1,13,0,12,16292.86,12
2021-12-16 14:30:00+00:00,2,24,0,22,16178.21,22
2021-12-16 15:30:00+00:00,2,21,0,19,16064.29,19
2021-12-16 16:30:00+00:00,4,18,0,14,15949.47,14
2021-12-16 17:30:00+00:00,4,19,0,15,15966.55,15
2021-12-16 18:30:00+00:00,5,15,0,10,15857.51,10
2021-12-16 19:30:00+00:00,4,11,0,7,15889.33,7
2021-12-16 20:30:00+00:00,4,13,0,9,15867.27,9
2021-12-17 14:30:00+00:00,5,8,0,3,15739.48,3
2021-12-17 15:30:00+00:00,4,17,0,13,15925.29,13
2021-12-17 16:30:00+00:00,4,11,0,7,15815.20,7
2021-12-17 17:30:00+00:00,3,15,0,12,15882.22,12
2021-12-17 18:30:00+00:00,5,14,0,9,15859.60,9
2021-12-17 19:30:00+00:00,19,5,14,0,15844.75,-14
2021-12-17 20:30:00+00:00,32,4,28,0,15797.12,-28
2021-12-20 14:30:00+00:00,46,4,42,0,15591.79,-42
2021-12-20 15:30:00+00:00,40,4,36,0,15535.36,-36
2021-12-20 16:30:00+00:00,29,4,25,0,15571.80,-25
2021-12-20 17:30:00+00:00,28,4,24,0,15550.50,-24
2021-12-20 18:30:00+00:00,22,5,17,0,15583.65,-17
2021-12-20 19:30:00+00:00,20,5,15,0,15624.41,-15
2021-12-20 20:30:00+00:00,14,4,10,0,15624.27,-10
2021-12-21 14:30:00+00:00,8,6,2,0,15636.40,-2
2021-12-21 15:30:00+00:00,15,6,9,0,15730.51,-9
2021-12-21 16:30:00+00:00,2,9,0,7,15843.64,7
2021-12-21 17:30:00+00:00,5,6,0,1,15892.02,1
2021-12-21 18:30:00+00:00,4,12,0,8,15944.61,8
2021-12-21 19:30:00+00:00,3,15,0,12,15949.07,12
2021-12-21 20:30:00+00:00,1,20,0,19,15986.50,19
2021-12-22 14:30:00+00:00,1,45,0,44,16016.46,44
2021-12-22 15:30:00+00:00,1,63,0,62,16121.36,62
2021-12-22 16:30:00+00:00,1,63,0,62,16116.11,62
2021-12-22 17:30:00+00:00,1,61,0,60,16085.16,60
2021-12-22 18:30:00+00:00,1,56,0,55,16056.06,55
2021-12-22 19:30:00+00:00,1,55,0,54,16128.04,54
2021-12-22 20:30:00+00:00,2,62,0,60,16179.47,60
2021-12-23 14:30:00+00:00,1,66,0,65,16270.82,65
2021-12-23 15:30:00+00:00,1,61,0,60,16304.21,60
2021-12-23 16:30:00+00:00,0,46,0,46,16311.39,46
2021-12-23 17:30:00+00:00,1,47,0,46,16335.21,46
2021-12-23 18:30:00+00:00,2,50,0,48,16333.96,48
2021-12-23 19:30:00+00:00,1,47,0,46,16322.77,46
2021-12-23 20:30:00+00:00,2,40,0,38,16303.72,38
2021-12-27 14:30:00+00:00,3,59,0,56,16506.49,56
2021-12-27 15:30:00+00:00,2,49,0,47,16522.12,47
2021-12-27 16:30:00+00:00,2,52,0,50,16532.41,50
2021-12-27 17:30:00+00:00,2,52,0,50,16545.00,50
2021-12-27 18:30:00+00:00,1,54,0,53,16559.22,53
2021-12-27 19:30:00+00:00,2,54,0,52,16541.09,52
2021-12-27 20:30:00+00:00,2,52,0,50,16567.47,50
2021-12-28 14:30:00+00:00,3,34,0,31,16551.70,31
2021-12-28 15:30:00+00:00,4,34,0,30,16528.26,30
2021-12-28 16:30:00+00:00,2,35,0,33,16514.05,33
2021-12-28 17:30:00+00:00,6,30,0,24,16496.98,24
2021-12-28 18:30:00+00:00,6,28,0,22,16488.83,22
2021-12-28 19:30:00+00:00,3,33,0,30,16501.65,30
2021-12-28 20:30:00+00:00,3,34,0,31,16492.75,31
2021-12-29 14:30:00+00:00,20,24,0,4,16438.23,4
2021-12-29 15:30:00+00:00,14,22,0,8,16451.42,8
2021-12-29 16:30:00+00:00,20,15,5,0,16429.57,-5
2021-12-29 17:30:00+00:00,17,19,0,2,16446.90,2
2021-12-29 18:30:00+00:00,13,20,0,7,16486.66,7
2021-12-29 19:30:00+00:00,10,23,0,13,16488.28,13
2021-12-29 20:30:00+00:00,9,16,0,7,16491.55,7
2021-12-30 14:30:00+00:00,2,11,0,9,16560.87,9
2021-12-30 15:30:00+00:00,2,12,0,10,16551.55,10
2021-12-30 16:30:00+00:00,1,12,0,11,16545.65,11
2021-12-30 17:30:00+00:00,1,15,0,14,16542.76,14
2021-12-30 18:30:00+00:00,2,14,0,12,16530.03,12
2021-12-30 19:30:00+00:00,1,13,0,12,16501.89,12
2021-12-30 20:30:00+00:00,3,6,0,3,16436.09,3
2021-12-31 14:30:00+00:00,8,8,0,0,16405.95,0
2021-12-31 15:30:00+00:00,9,9,0,0,16404.13,0
2021-12-31 16:30:00+00:00,8,8,0,0,16366.52,0
2021-12-31 17:30:00+00:00,9,9,0,0,16390.69,0
2021-12-31 18:30:00+00:00,17,5,12,0,16367.27,-12
2021-12-31 19:30:00+00:00,16,8,8,0,16384.92,-8
2021-12-31 20:30:00+00:00,26,5,21,0,16321.55,-21
2022-01-03 14:30:00+00:00,38,3,35,0,16421.35,-35
2022-01-03 15:30:00+00:00,46,1,45,0,16415.97,-45
2022-01-03 16:30:00+00:00,44,2,42,0,16422.93,-42
2022-01-03 17:30:00+00:00,45,2,43,0,16438.31,-43
2022-01-03 18:30:00+00:00,37,3,34,0,16470.51,-34
2022-01-03 19:30:00+00:00,33,4,29,0,16490.13,-29
2022-01-03 20:30:00+00:00,23,10,13,0,16496.56,-13
2022-01-04 14:30:00+00:00,36,9,27,0,16408.88,-27
2022-01-04 15:30:00+00:00,36,6,30,0,16197.51,-30
2022-01-04 16:30:00+00:00,36,5,31,0,16221.06,-31
2022-01-04 17:30:00+00:00,40,4,36,0,16205.13,-36
2022-01-04 18:30:00+00:00,41,4,37,0,16177.11,-37
2022-01-04 19:30:00+00:00,25,4,21,0,16295.61,-21
2022-01-04 20:30:00+00:00,23,7,16,0,16278.88,-16
2022-01-05 14:30:00+00:00,22,10,12,0,16206.88,-12
2022-01-05 15:30:00+00:00,24,13,11,0,16172.34,-11
2022-01-05 16:30:00+00:00,26,12,14,0,16140.11,-14
2022-01-05 17:30:00+00:00,32,10,22,0,16082.26,-22
2022-01-05 18:30:00+00:00,47,7,40,0,15981.49,-40
2022-01-05 19:30:00+00:00,53,5,48,0,15844.29,-48
2022-01-05 20:30:00+00:00,57,2,55,0,15764.91,-55
2022-01-06 14:30:00+00:00,42,1,41,0,15775.07,-41
2022-01-06 15:30:00+00:00,27,0,27,0,15829.37,-27
2022-01-06 16:30:00+00:00,27,2,25,0,15838.54,-25
2022-01-06 17:30:00+00:00,30,1,29,0,15785.56,-29
2022-01-06 18:30:00+00:00,25,4,21,0,15807.94,-21
2022-01-06 19:30:00+00:00,36,1,35,0,15813.36,-35
2022-01-06 20:30:00+00:00,41,1,40,0,15767.14,-40
2022-01-07 14:30:00+00:00,46,3,43,0,15672.89,-43
2022-01-07 15:30:00+00:00,48,5,43,0,15624.11,-43
2022-01-07 16:30:00+00:00,45,2,43,0,15631.19,-43
2022-01-07 17:30:00+00:00,46,3,43,0,15625.11,-43
2022-01-07 18:30:00+00:00,42,3,39,0,15590.79,-39
2022-01-07 19:30:00+00:00,33,8,25,0,15622.60,-25
2022-01-07 20:30:00+00:00,31,9,22,0,15588.72,-22
2022-01-10 14:30:00+00:00,53,4,49,0,15241.36,-49
2022-01-10 15:30:00+00:00,56,3,53,0,15337.18,-53
2022-01-10 16:30:00+00:00,62,2,60,0,15230.77,-60
2022-01-10 17:30:00+00:00,48,2,46,0,15370.15,-46
2022-01-10 18:30:00+00:00,37,4,33,0,15486.79,-33
2022-01-10 19:30:00+00:00,37,3,34,0,15489.10,-34
2022-01-10 20:30:00+00:00,18,6,12,0,15614.06,-12
2022-01-11 14:30:00+00:00,13,7,6,0,15612.47,-6
2022-01-11 15:30:00+00:00,6,8,0,2,15759.69,2
2022-01-11 16:30:00+00:00,5,5,0,0,15759.94,0
2022-01-11 17:30:00+00:00,4,7,0,3,15795.54,3
2022-01-11 18:30:00+00:00,3,10,0,7,15799.32,7
2022-01-11 19:30:00+00:00,1,11,0,10,15830.27,10
2022-01-11 20:30:00+00:00,1,12,0,11,15842.34,11
2022-01-12 14:30:00+00:00,2,60,0,58,15990.55,58
2022-01-12 15:30:00+00:00,1,45,0,44,15879.31,44
2022-01-12 16:30:00+00:00,0,59,0,59,15916.40,59
2022-01-12 17:30:00+00:00,0,52,0,52,15909.02,52
2022-01-12 18:30:00+00:00,0,45,0,45,15924.51,45
2022-01-12 19:30:00+00:00,0,39,0,39,15883.73,39
2022-01-12 20:30:00+00:00,1,28,0,27,15903.74,27
2022-01-13 14:30:00+00:00,2,31,0,29,15875.66,29
2022-01-13 15:30:00+00:00,8,21,0,13,15820.32,13
2022-01-13 16:30:00+00:00,16,10,6,0,15646.05,-6
2022-01-13 17:30:00+00:00,14,10,4,0,15680.08,-4
2022-01-13 18:30:00+00:00,16,8,8,0,15641.83,-8
2022-01-13 19:30:00+00:00,27,3,24,0,15587.94,-24
2022-01-13 20:30:00+00:00,31,3,28,0,15504.69,-28
2022-01-14 14:30:00+00:00,48,6,42,0,15525.37,-42
2022-01-14 15:30:00+00:00,44,4,40,0,15479.88,-40
2022-01-14 16:30:00+00:00,47,3,44,0,15524.72,-44
2022-01-14 17:30:00+00:00,51,3,48,0,15433.84,-48
2022-01-14 18:30:00+00:00,47,3,44,0,15491.67,-44
2022-01-14 19:30:00+00:00,32,6,26,0,15573.95,-26
2022-01-14 20:30:00+00:00,28,6,22,0,15606.71,-22
2022-01-18 14:30:00+00:00,39,2,37,0,15425.71,-37
2022-01-18 15:30:00+00:00,47,0,47,0,15302.99,-47
2022-01-18 16:30:00+00:00,35,1,34,0,15301.53,-34
2022-01-18 17:30:00+00:00,41,1,40,0,15253.23,-40
2022-01-18 18:30:00+00:00,34,2,32,0,15272.64,-32
2022-01-18 19:30:00+00:00,34,3,31,0,15258.25,-31
2022-01-18 20:30:00+00:00,32,1,31,0,15218.98,-31
2022-01-19 14:30:00+00:00,20,1,19,0,15298.72,-19
2022-01-19 15:30:00+00:00,25,2,23,0,15150.76,-23
2022-01-19 16:30:00+00:00,13,3,10,0,15305.70,-10
2022-01-19 17:30:00+00:00,11,3,8,0,15275.04,-8
2022-01-19 18:30:00+00:00,18,4,14,0,15168.52,-14
2022-01-19 19:30:00+00:00,37,1,36,0,15149.35,-36
2022-01-19 20:30:00+00:00,47,0,47,0,15046.96,-47
2022-01-20 14:30:00+00:00,17,4,13,0,15283.76,-13
2022-01-20 15:30:00+00:00,10,6,4,0,15312.81,-4
2022-01-20 16:30:00+00:00,7,5,2,0,15295.59,-2
2022-01-20 17:30:00+00:00,10,6,4,0,15216.56,-4
2022-01-20 18:30:00+00:00,15,3,12,0,15147.63,-12
2022-01-20 19:30:00+00:00,20,2,18,0,14981.99,-18
2022-01-20 20:30:00+00:00,22,4,18,0,14847.44,-18
2022-01-21 14:30:00+00:00,29,2,27,0,14639.23,-27
2022-01-21 15:30:00+00:00,11,1,10,0,14849.77,-10
2022-01-21 16:30:00+00:00,27,1,26,0,14664.79,-26
2022-01-21 17:30:00+00:00,30,0,30,0,14612.79,-30
2022-01-21 18:30:00+00:00,24,0,24,0,14577.28,-24
2022-01-21 19:30:00+00:00,33,1,32,0,14479.89,-32
2022-01-21 20:30:00+00:00,22,1,21,0,14432.64,-21
2022-01-24 14:30:00+00:00,74,0,74,0,14092.77,-74
2022-01-24 15:30:00+00:00,76,3,73,0,14032.59,-73
2022-01-24 16:30:00+00:00,81,1,80,0,13802.75,-80
2022-01-24 17:30:00+00:00,73,1,72,0,13990.02,-72
2022-01-24 18:30:00+00:00,55,1,54,0,14084.92,-54
2022-01-24 19:30:00+00:00,23,1,22,0,14275.26,-22
2022-01-24 20:30:00+00:00,6,0,6,0,14517.10,-6
2022-01-25 14:30:00+00:00,4,0,4,0,14215.55,-4
2022-01-25 15:30:00+00:00,18,1,17,0,14145.70,-17
2022-01-25 16:30:00+00:00,9,0,9,0,14133.13,-9
2022-01-25 17:30:00+00:00,3,1,2,0,14186.20,-2
2022-01-25 18:30:00+00:00,1,0,1,0,14328.82,-1
2022-01-25 19:30:00+00:00,1,1,0,0,14224.12,0
2022-01-25 20:30:00+00:00,1,0,1,0,14154.72,-1
2022-01-26 14:30:00+00:00,1,3,0,2,14395.72,2
2022-01-26 15:30:00+00:00,0,10,0,10,14447.38,10
2022-01-26 16:30:00+00:00,0,26,0,26,14509.74,26
2022-01-26 17:30:00+00:00,1,13,0,12,14508.87,12
2022-01-26 18:30:00+00:00,1,10,0,9,14521.91,9
2022-01-26 19:30:00+00:00,10,0,10,0,14179.67,-10
2022-01-26 20:30:00+00:00,32,0,32,0,14168.90,-32
2022-01-27 14:30:00+00:00,10,3,7,0,14275.68,-7
2022-01-27 15:30:00+00:00,7,4,3,0,14263.68,-3
2022-01-27 16:30:00+00:00,9,2,7,0,14175.06,-7
2022-01-27 17:30:00+00:00,16,2,14,0,14005.04,-14
2022-01-27 18:30:00+00:00,22,1,21,0,14027.97,-21
2022-01-27 19:30:00+00:00,19,1,18,0,14014.35,-18
2022-01-27 20:30:00+00:00,17,1,16,0,13998.89,-16
2022-01-28 14:30:00+00:00,47,1,46,0,13980.10,-46
2022-01-28 15:30:00+00:00,23,1,22,0,14232.06,-22
2022-01-28 16:30:00+00:00,22,2,20,0,14242.75,-20
2022-01-28 17:30:00+00:00,25,1,24,0,14224.41,-24
2022-01-28 18:30:00+00:00,32,1,31,0,14105.29,-31
2022-01-28 19:30:00+00:00,4,7,0,3,14270.75,3
2022-01-28 20:30:00+00:00,3,9,0,6,14451.05,6
2022-01-31 14:30:00+00:00,0,10,0,10,14680.63,10
2022-01-31 15:30:00+00:00,1,17,0,16,14690.51,16
2022-01-31 16:30:00+00:00,0,37,0,37,14753.02,37
2022-01-31 17:30:00+00:00,0,64,0,64,14762.83,64
2022-01-31 18:30:00+00:00,0,67,0,67,14833.16,67
2022-01-31 19:30:00+00:00,1,67,0,66,14786.43,66
2022-01-31 20:30:00+00:00,0,73,0,73,14930.82,73
2022-02-01 14:30:00+00:00,0,71,0,71,14837.86,71
2022-02-01 15:30:00+00:00,0,63,0,63,14909.35,63
2022-02-01 16:30:00+00:00,0,62,0,62,14908.30,62
2022-02-01 17:30:00+00:00,0,61,0,61,14917.28,61
2022-02-01 18:30:00+00:00,0,72,0,72,14867.81,72
2022-02-01 19:30:00+00:00,0,66,0,66,14964.21,66
2022-02-01 20:30:00+00:00,1,61,0,60,15012.63,60
2022-02-02 14:30:00+00:00,2,34,0,32,15081.29,32
2022-02-02 15:30:00+00:00,2,29,0,27,15018.08,27
2022-02-02 16:30:00+00:00,2,24,0,22,15049.66,22
2022-02-02 17:30:00+00:00,2,24,0,22,15070.46,22
2022-02-02 18:30:00+00:00,2,24,0,22,15067.58,22
2022-02-02 19:30:00+00:00,1,29,0,28,15123.34,28
2022-02-02 20:30:00+00:00,3,20,0,17,15132.65,17
2022-02-03 14:30:00+00:00,8,31,0,23,14829.58,23
2022-02-03 15:30:00+00:00,18,19,0,1,14739.70,1
2022-02-03 16:30:00+00:00,20,17,3,0,14692.77,-3
2022-02-03 17:30:00+00:00,20,18,2,0,14702.28,-2
2022-02-03 18:30:00+00:00,19,15,4,0,14656.01,-4
2022-02-03 19:30:00+00:00,29,11,18,0,14614.60,-18
2022-02-03 20:30:00+00:00,39,9,30,0,14498.18,-30
2022-02-04 14:30:00+00:00,27,3,24,0,14585.80,-24
2022-02-04 15:30:00+00:00,34,2,32,0,14549.68,-32
2022-02-04 16:30:00+00:00,30,1,29,0,14605.90,-29
2022-02-04 17:30:00+00:00,24,2,22,0,14721.25,-22
2022-02-04 18:30:00+00:00,20,2,18,0,14734.42,-18
2022-02-04 19:30:00+00:00,21,2,19,0,14791.54,-19
2022-02-04 20:30:00+00:00,31,1,30,0,14691.72,-30
2022-02-07 14:30:00+00:00,12,5,7,0,14750.67,-7
2022-02-07 15:30:00+00:00,13,6,7,0,14683.88,-7
2022-02-07 16:30:00+00:00,17,4,13,0,14607.49,-13
2022-02-07 17:30:00+00:00,13,6,7,0,14671.53,-7
2022-02-07 18:30:00+00:00,9,9,0,0,14698.66,0
2022-02-07 19:30:00+00:00,9,5,4,0,14651.98,-4
2022-02-07 20:30:00+00:00,7,9,0,2,14573.07,2
2022-02-08 14:30:00+00:00,3,5,0,2,14515.55,2
2022-02-08 15:30:00+00:00,1,20,0,19,14677.03,19
2022-02-08 16:30:00+00:00,2,19,0,17,14710.53,17
2022-02-08 17:30:00+00:00,3,12,0,9,14698.64,9
2022-02-08 18:30:00+00:00,5,8,0,3,14648.80,3
2022-02-08 19:30:00+00:00,7,8,0,1,14704.62,1
2022-02-08 20:30:00+00:00,4,14,0,10,14743.16,10
2022-02-09 14:30:00+00:00,0,22,0,22,14913.82,22
2022-02-09 15:30:00+00:00,1,27,0,26,14954.58,26
2022-02-09 16:30:00+00:00,0,42,0,42,14968.58,42
2022-02-09 17:30:00+00:00,0,37,0,37,14990.76,37
2022-02-09 18:30:00+00:00,1,38,0,37,15021.14,37
2022-02-09 19:30:00+00:00,1,46,0,45,15015.16,45
2022-02-09 20:30:00+00:00,1,53,0,52,15055.59,52
2022-02-10 14:30:00+00:00,5,52,0,47,14963.07,47
2022-02-10 15:30:00+00:00,9,39,0,30,14920.02,30
2022-02-10 16:30:00+00:00,7,42,0,35,14972.36,35
2022-02-10 17:30:00+00:00,8,23,0,15,14795.84,15
2022-02-10 18:30:00+00:00,8,29,0,21,14779.81,21
2022-02-10 19:30:00+00:00,10,12,0,2,14738.85,2
2022-02-10 20:30:00+00:00,10,8,2,0,14704.52,-2
2022-02-11 14:30:00+00:00,23,6,17,0,14663.86,-17
2022-02-11 15:30:00+00:00,44,4,40,0,14589.34,-40
2022-02-11 16:30:00+00:00,43,4,39,0,14584.03,-39
2022-02-11 17:30:00+00:00,54,3,51,0,14495.03,-51
2022-02-11 18:30:00+00:00,68,1,67,0,14292.26,-67
2022-02-11 19:30:00+00:00,65,1,64,0,14271.93,-64
2022-02-11 20:30:00+00:00,68,1,67,0,14245.24,-67
2022-02-14 14:30:00+00:00,68,0,68,0,14284.23,-68
2022-02-14 15:30:00+00:00,63,1,62,0,14372.15,-62
2022-02-14 16:30:00+00:00,67,0,67,0,14373.08,-67
2022-02-14 17:30:00+00:00,56,0,56,0,14309.89,-56
2022-02-14 18:30:00+00:00,58,0,58,0,14223.37,-58
2022-02-14 19:30:00+00:00,52,0,52,0,14258.46,-52
2022-02-14 20:30:00+00:00,48,0,48,0,14269.90,-48
2022-02-15 14:30:00+00:00,15,0,15,0,14505.21,-15
2022-02-15 15:30:00+00:00,6,0,6,0,14526.75,-6
2022-02-15 16:30:00+00:00,10,0,10,0,14489.93,-10
2022-02-15 17:30:00+00:00,6,0,6,0,14543.93,-6
2022-02-15 18:30:00+00:00,3,22,0,19,14553.82,19
2022-02-15 19:30:00+00:00,3,28,0,25,14591.45,25
2022-02-15 20:30:00+00:00,1,35,0,34,14621.79,34
2022-02-16 14:30:00+00:00,1,12,0,11,14439.81,11
2022-02-16 15:30:00+00:00,2,11,0,9,14461.12,9
2022-02-16 16:30:00+00:00,2,12,0,10,14449.31,10
2022-02-16 17:30:00+00:00,2,15,0,13,14443.47,13
2022-02-16 18:30:00+00:00,2,31,0,29,14567.44,29
2022-02-16 19:30:00+00:00,2,38,0,36,14641.59,36
2022-02-16 20:30:00+00:00,2,32,0,30,14604.02,30
2022-02-17 14:30:00+00:00,13,5,8,0,14351.35,-8
2022-02-17 15:30:00+00:00,10,5,5,0,14406.60,-5
2022-02-17 16:30:00+00:00,11,1,10,0,14352.94,-10
2022-02-17 17:30:00+00:00,16,2,14,0,14311.15,-14
2022-02-17 18:30:00+00:00,17,2,15,0,14280.99,-15
2022-02-17 19:30:00+00:00,28,0,28,0,14205.66,-28
2022-02-17 20:30:00+00:00,38,0,38,0,14173.55,-38
2022-02-18 14:30:00+00:00,27,1,26,0,14104.16,-26
2022-02-18 15:30:00+00:00,40,2,38,0,14041.37,-38
2022-02-18 16:30:00+00:00,41,1,40,0,14023.67,-40
2022-02-18 17:30:00+00:00,49,1,48,0,13939.98,-48
2022-02-18 18:30:00+00:00,43,1,42,0,14094.02,-42
2022-02-18 19:30:00+00:00,61,1,60,0,14024.58,-60
2022-02-18 20:30:00+00:00,55,1,54,0,14004.20,-54
2022-02-22 14:30:00+00:00,18,1,17,0,14106.98,-17
2022-02-22 15:30:00+00:00,37,2,35,0,13902.25,-35
2022-02-22 16:30:00+00:00,32,0,32,0,13862.48,-32
2022-02-22 17:30:00+00:00,36,0,36,0,13818.46,-36
2022-02-22 18:30:00+00:00,34,0,34,0,13805.61,-34
2022-02-22 19:30:00+00:00,12,0,12,0,13976.50,-12
2022-02-22 20:30:00+00:00,15,0,15,0,13872.21,-15
2022-02-23 14:30:00+00:00,15,0,15,0,13814.37,-15
2022-02-23 15:30:00+00:00,13,0,13,0,13743.01,-13
2022-02-23 16:30:00+00:00,6,1,5,0,13861.74,-5
2022-02-23 17:30:00+00:00,9,0,9,0,13681.14,-9
2022-02-23 18:30:00+00:00,21,1,20,0,13624.56,-20
2022-02-23 19:30:00+00:00,19,0,19,0,13589.10,-19
2022-02-23 20:30:00+00:00,26,0,26,0,13512.73,-26
2022-02-24 14:30:00+00:00,61,0,61,0,13379.01,-61
2022-02-24 15:30:00+00:00,31,1,30,0,13500.13,-30
2022-02-24 16:30:00+00:00,30,1,29,0,13454.05,-29
2022-02-24 17:30:00+00:00,23,4,19,0,13493.32,-19
2022-02-24 18:30:00+00:00,15,2,13,0,13671.46,-13
2022-02-24 19:30:00+00:00,15,1,14,0,13821.53,-14
2022-02-24 20:30:00+00:00,6,7,0,1,13970.50,1
2022-02-25 14:30:00+00:00,3,8,0,5,14006.61,5
2022-02-25 15:30:00+00:00,3,16,0,13,14126.45,13
2022-02-25 16:30:00+00:00,1,14,0,13,14150.51,13
2022-02-25 17:30:00+00:00,3,28,0,25,14112.19,25
2022-02-25 18:30:00+00:00,1,44,0,43,14138.71,43
2022-02-25 19:30:00+00:00,1,47,0,46,14143.76,46
2022-02-25 20:30:00+00:00,0,62,0,62,14192.02,62
2022-02-28 14:30:00+00:00,0,60,0,60,14106.00,60
2022-02-28 15:30:00+00:00,0,65,0,65,14271.18,65
2022-02-28 16:30:00+00:00,0,51,0,51,14154.74,51
2022-02-28 17:30:00+00:00,0,44,0,44,14122.25,44
2022-02-28 18:30:00+00:00,0,23,0,23,14025.42,23
2022-02-28 19:30:00+00:00,0,21,0,21,14115.67,21
2022-02-28 20:30:00+00:00,0,20,0,20,14239.08,20
2022-03-01 14:30:00+00:00,1,19,0,18,14248.56,18
2022-03-01 15:30:00+00:00,1,13,0,12,14148.91,12
2022-03-01 16:30:00+00:00,8,8,0,0,14066.09,0
2022-03-01 17:30:00+00:00,9,9,0,0,13984.13,0
2022-03-01 18:30:00+00:00,6,9,0,3,14044.07,3
2022-03-01 19:30:00+00:00,7,4,3,0,13990.69,-3
2022-03-01 20:30:00+00:00,11,3,8,0,14008.13,-8
2022-03-02 14:30:00+00:00,3,6,0,3,14086.15,3
2022-03-02 15:30:00+00:00,7,2,5,0,14176.67,-5
2022-03-02 16:30:00+00:00,6,6,0,0,14185.78,0
2022-03-02 17:30:00+00:00,4,7,0,3,14246.28,3
2022-03-02 18:30:00+00:00,2,16,0,14,14241.93,14
2022-03-02 19:30:00+00:00,5,12,0,7,14269.82,7
2022-03-02 20:30:00+00:00,6,8,0,2,14240.38,2
2022-03-03 14:30:00+00:00,18,11,7,0,14150.54,-7
2022-03-03 15:30:00+00:00,9,10,0,1,14109.91,1
2022-03-03 16:30:00+00:00,13,13,0,0,14062.83,0
2022-03-03 17:30:00+00:00,6,24,0,18,14183.97,18
2022-03-03 18:30:00+00:00,9,19,0,10,14150.47,10
2022-03-03 19:30:00+00:00,10,17,0,7,14046.27,7
2022-03-03 20:30:00+00:00,9,14,0,5,14036.04,5
2022-03-04 14:30:00+00:00,23,3,20,0,13831.83,-20
2022-03-04 15:30:00+00:00,45,4,41,0,13785.85,-41
2022-03-04 16:30:00+00:00,40,6,34,0,13868.97,-34
2022-03-04 17:30:00+00:00,46,7,39,0,13870.51,-39
2022-03-04 18:30:00+00:00,47,5,42,0,13817.11,-42
2022-03-04 19:30:00+00:00,50,5,45,0,13793.05,-45
2022-03-04 20:30:00+00:00,47,5,42,0,13844.72,-42
2022-03-07 14:30:00+00:00,53,6,47,0,13580.81,-47
2022-03-07 15:30:00+00:00,48,5,43,0,13617.98,-43
2022-03-07 16:30:00+00:00,48,6,42,0,13526.50,-42
2022-03-07 17:30:00+00:00,61,5,56,0,13480.32,-56
2022-03-07 18:30:00+00:00,63,2,61,0,13484.92,-61
2022-03-07 19:30:00+00:00,59,4,55,0,13415.45,-55
2022-03-07 20:30:00+00:00,63,3,60,0,13315.48,-60
2022-03-08 14:30:00+00:00,61,3,58,0,13192.22,-58
2022-03-08 15:30:00+00:00,54,2,52,0,13199.61,-52
2022-03-08 16:30:00+00:00,26,2,24,0,13512.01,-24
2022-03-08 17:30:00+00:00,28,2,26,0,13523.26,-26
2022-03-08 18:30:00+00:00,26,2,24,0,13418.63,-24
2022-03-08 19:30:00+00:00,28,1,27,0,13350.87,-27
2022-03-08 20:30:00+00:00,39,1,38,0,13270.44,-38
2022-03-09 14:30:00+00:00,8,6,2,0,13631.86,-2
2022-03-09 15:30:00+00:00,8,2,6,0,13600.64,-6
2022-03-09 16:30:00+00:00,5,6,0,1,13675.09,1
2022-03-09 17:30:00+00:00,4,14,0,10,13735.42,10
2022-03-09 18:30:00+00:00,4,9,0,5,13712.92,5
2022-03-09 19:30:00+00:00,0,21,0,21,13772.07,21
2022-03-09 20:30:00+00:00,2,30,0,28,13741.17,28
2022-03-10 14:30:00+00:00,4,15,0,11,13532.49,11
2022-03-10 15:30:00+00:00,4,10,0,6,13412.00,6
2022-03-10 16:30:00+00:00,8,4,4,0,13493.15,-4
2022-03-10 17:30:00+00:00,6,2,4,0,13475.53,-4
2022-03-10 18:30:00+00:00,2,10,0,8,13590.19,8
2022-03-10 19:30:00+00:00,2,10,0,8,13583.36,8
2022-03-10 20:30:00+00:00,1,16,0,15,13589.76,15
2022-03-11 14:30:00+00:00,11,7,4,0,13546.92,-4
2022-03-11 15:30:00+00:00,9,7,2,0,13477.27,-2
2022-03-11 16:30:00+00:00,27,4,23,0,13426.25,-23
2022-03-11 17:30:00+00:00,28,4,24,0,13495.81,-24
2022-03-11 18:30:00+00:00,24,5,19,0,13485.67,-19
2022-03-11 19:30:00+00:00,39,5,34,0,13375.62,-34
2022-03-11 20:30:00+00:00,41,0,41,0,13289.55,-41
2022-03-14 13:30:00+00:00,18,5,13,0,13341.85,-13
2022-03-14 14:30:00+00:00,19,8,11,0,13260.24,-11
2022-03-14 15:30:00+00:00,36,4,32,0,13161.75,-32
2022-03-14 16:30:00+00:00,41,1,40,0,13051.13,-40
2022-03-14 17:30:00+00:00,56,0,56,0,13038.94,-56
2022-03-14 18:30:00+00:00,47,0,47,0,13078.29,-47
2022-03-14 19:30:00+00:00,49,0,49,0,13042.04,-49
2022-03-15 13:30:00+00:00,26,1,25,0,13262.25,-25
2022-03-15 14:30:00+00:00,17,2,15,0,13355.77,-15
2022-03-15 15:30:00+00:00,13,3,10,0,13378.70,-10
2022-03-15 16:30:00+00:00,17,1,16,0,13299.42,-16
2022-03-15 17:30:00+00:00,16,0,16,0,13298.36,-16
2022-03-15 18:30:00+00:00,5,5,0,0,13439.50,0
2022-03-15 19:30:00+00:00,3,9,0,6,13454.76,6
2022-03-16 13:30:00+00:00,0,30,0,30,13827.94,30
2022-03-16 14:30:00+00:00,0,37,0,37,13821.77,37
2022-03-16 15:30:00+00:00,3,45,0,42,13794.32,42
2022-03-16 16:30:00+00:00,0,49,0,49,13691.11,49
2022-03-16 17:30:00+00:00,1,21,0,20,13536.75,20
2022-03-16 18:30:00+00:00,0,50,0,50,13851.06,50
2022-03-16 19:30:00+00:00,0,63,0,63,13960.25,63
2022-03-17 13:30:00+00:00,1,45,0,44,13954.64,44
2022-03-17 14:30:00+00:00,0,35,0,35,13916.52,35
2022-03-17 15:30:00+00:00,0,37,0,37,13971.67,37
2022-03-17 16:30:00+00:00,0,59,0,59,14036.69,59
2022-03-17 17:30:00+00:00,0,56,0,56,14020.79,56
2022-03-17 18:30:00+00:00,0,40,0,40,14058.62,40
2022-03-17 19:30:00+00:00,0,48,0,48,14115.90,48
2022-03-18 13:30:00+00:00,0,28,0,28,14215.84,28
2022-03-18 14:30:00+00:00,0,31,0,31,14236.26,31
2022-03-18 15:30:00+00:00,0,39,0,39,14279.88,39
2022-03-18 16:30:00+00:00,0,54,0,54,14316.67,54
2022-03-18 17:30:00+00:00,0,69,0,69,14315.69,69
2022-03-18 18:30:00+00:00,0,60,0,60,14394.96,60
2022-03-18 19:30:00+00:00,0,57,0,57,14425.43,57
2022-03-21 13:30:00+00:00,1,15,0,14,14235.68,14
2022-03-21 14:30:00+00:00,0,28,0,28,14436.58,28
2022-03-21 15:30:00+00:00,1,21,0,20,14410.33,20
2022-03-21 16:30:00+00:00,2,3,0,1,14219.83,1
2022-03-21 17:30:00+00:00,1,5,0,4,14332.98,4
2022-03-21 18:30:00+00:00,0,4,0,4,14320.53,4
2022-03-21 19:30:00+00:00,0,5,0,5,14377.46,5
2022-03-22 13:30:00+00:00,0,9,0,9,14589.20,9
2022-03-22 14:30:00+00:00,0,11,0,11,14673.02,11
2022-03-22 15:30:00+00:00,0,8,0,8,14590.99,8
2022-03-22 16:30:00+00:00,0,8,0,8,14607.71,8
2022-03-22 17:30:00+00:00,0,3,0,3,14620.32,3
2022-03-22 18:30:00+00:00,0,2,0,2,14645.54,2
2022-03-22 19:30:00+00:00,0,1,0,1,14656.98,1
2022-03-23 13:30:00+00:00,1,11,0,10,14581.02,10
2022-03-23 14:30:00+00:00,0,10,0,10,14631.30,10
2022-03-23 15:30:00+00:00,1,11,0,10,14628.65,10
2022-03-23 16:30:00+00:00,1,15,0,14,14504.64,14
2022-03-23 17:30:00+00:00,4,12,0,8,14520.09,8
2022-03-23 18:30:00+00:00,3,11,0,8,14501.71,8
2022-03-23 19:30:00+00:00,11,5,6,0,14448.20,-6
2022-03-24 13:30:00+00:00,23,4,19,0,14460.24,-19
2022-03-24 14:30:00+00:00,15,5,10,0,14624.84,-10
2022-03-24 15:30:00+00:00,12,4,8,0,14604.74,-8
2022-03-24 16:30:00+00:00,12,5,7,0,14648.02,-7
2022-03-24 17:30:00+00:00,11,5,6,0,14655.99,-6
2022-03-24 18:30:00+00:00,7,8,0,1,14724.61,1
2022-03-24 19:30:00+00:00,5,8,0,3,14767.50,3
2022-03-25 13:30:00+00:00,4,14,0,10,14746.88,10
2022-03-25 14:30:00+00:00,16,3,13,0,14598.32,-13
2022-03-25 15:30:00+00:00,8,8,0,0,14653.32,0
2022-03-25 16:30:00+00:00,3,14,0,11,14655.62,11
2022-03-25 17:30:00+00:00,3,18,0,15,14726.12,15
2022-03-25 18:30:00+00:00,6,11,0,5,14648.31,5
2022-03-25 19:30:00+00:00,2,24,0,22,14759.36,22
2022-03-28 14:30:00+01:00,1,14,0,13,14819.34,13
2022-03-28 15:30:00+01:00,1,9,0,8,14828.36,8
2022-03-28 16:30:00+01:00,2,8,0,6,14729.92,6
2022-03-28 17:30:00+01:00,1,9,0,8,14837.79,8
2022-03-28 18:30:00+01:00,2,10,0,8,14865.16,8
2022-03-28 19:30:00+01:00,2,10,0,8,14946.10,8
2022-03-28 20:30:00+01:00,2,10,0,8,14987.04,8
2022-03-29 14:30:00+01:00,0,21,0,21,15092.71,21
2022-03-29 15:30:00+01:00,0,61,0,61,15140.39,61
2022-03-29 16:30:00+01:00,1,52,0,51,15120.14,51
2022-03-29 17:30:00+01:00,1,49,0,48,15117.59,48
2022-03-29 18:30:00+01:00,0,48,0,48,15181.70,48
2022-03-29 19:30:00+01:00,0,63,0,63,15253.50,63
2022-03-29 20:30:00+01:00,0,55,0,55,15239.59,55
2022-03-30 14:30:00+01:00,0,48,0,48,15212.10,48
2022-03-30 15:30:00+01:00,0,34,0,34,15111.47,34
2022-03-30 16:30:00+01:00,1,53,0,52,15157.18,52
2022-03-30 17:30:00+01:00,1,41,0,40,15156.40,40
2022-03-30 18:30:00+01:00,0,27,0,27,15103.02,27
2022-03-30 19:30:00+01:00,0,14,0,14,15030.38,14
2022-03-30 20:30:00+01:00,2,14,0,12,15067.70,12
2022-03-31 14:30:00+01:00,15,13,2,0,15011.80,-2
2022-03-31 15:30:00+01:00,16,17,0,1,15026.57,1
2022-03-31 16:30:00+01:00,16,14,2,0,14998.85,-2
2022-03-31 17:30:00+01:00,12,16,0,4,15003.33,4
2022-03-31 18:30:00+01:00,30,12,18,0,14989.38,-18
2022-03-31 19:30:00+01:00,34,6,28,0,14982.44,-28
2022-03-31 20:30:00+01:00,45,1,44,0,14838.11,-44
2022-04-01 14:30:00+01:00,33,0,33,0,14833.63,-33
2022-04-01 15:30:00+01:00,27,1,26,0,14826.69,-26
2022-04-01 16:30:00+01:00,37,1,36,0,14777.39,-36
2022-04-01 17:30:00+01:00,38,1,37,0,14739.24,-37
2022-04-01 18:30:00+01:00,25,1,24,0,14817.13,-24
2022-04-01 19:30:00+01:00,22,4,18,0,14775.97,-18
2022-04-01 20:30:00+01:00,14,3,11,0,14858.99,-11
2022-04-04 14:30:00+01:00,7,11,0,4,15038.46,4
2022-04-04 15:30:00+01:00,9,10,0,1,15090.48,1
2022-04-04 16:30:00+01:00,7,16,0,9,15117.24,9
2022-04-04 17:30:00+01:00,9,16,0,7,15100.41,7
2022-04-04 18:30:00+01:00,9,15,0,6,15106.76,6
2022-04-04 19:30:00+01:00,4,17,0,13,15138.85,13
2022-04-04 20:30:00+01:00,3,33,0,30,15161.02,30
2022-04-05 14:30:00+01:00,9,14,0,5,14960.47,5
2022-04-05 15:30:00+01:00,10,17,0,7,14933.98,7
2022-04-05 16:30:00+01:00,8,13,0,5,14852.32,5
2022-04-05 17:30:00+01:00,4,14,0,10,14914.45,10
2022-04-05 18:30:00+01:00,6,9,0,3,14882.36,3
2022-04-05 19:30:00+01:00,8,5,3,0,14819.26,-3
2022-04-05 20:30:00+01:00,8,2,6,0,14825.32,-6
2022-04-06 14:30:00+01:00,56,5,51,0,14463.43,-51
2022-04-06 15:30:00+01:00,57,4,53,0,14475.28,-53
2022-04-06 16:30:00+01:00,61,8,53,0,14428.82,-53
2022-04-06 17:30:00+01:00,49,11,38,0,14475.11,-38
2022-04-06 18:30:00+01:00,54,6,48,0,14434.54,-48
2022-04-06 19:30:00+01:00,53,6,47,0,14486.34,-47
2022-04-06 20:30:00+01:00,50,8,42,0,14493.09,-42
2022-04-07 14:30:00+01:00,36,4,32,0,14516.76,-32
2022-04-07 15:30:00+01:00,42,4,38,0,14413.81,-38
2022-04-07 16:30:00+01:00,38,4,34,0,14375.24,-34
2022-04-07 17:30:00+01:00,33,6,27,0,14458.26,-27
2022-04-07 18:30:00+01:00,28,8,20,0,14484.76,-20
2022-04-07 19:30:00+01:00,13,7,6,0,14569.99,-6
2022-04-07 20:30:00+01:00,17,10,7,0,14526.97,-7
2022-04-08 14:30:00+01:00,1,12,0,11,14404.37,11
2022-04-08 15:30:00+01:00,1,13,0,12,14423.62,12
2022-04-08 16:30:00+01:00,3,15,0,12,14486.09,12
2022-04-08 17:30:00+01:00,3,10,0,7,14413.88,7
2022-04-08 18:30:00+01:00,3,13,0,10,14353.03,10
2022-04-08 19:30:00+01:00,5,10,0,5,14379.36,5
2022-04-08 20:30:00+01:00,9,8,1,0,14330.81,-1
2022-04-11 14:30:00+01:00,34,7,27,0,14070.24,-27
2022-04-11 15:30:00+01:00,18,9,9,0,14052.18,-9
2022-04-11 16:30:00+01:00,16,8,8,0,14047.00,-8
2022-04-11 17:30:00+01:00,20,3,17,0,14088.19,-17
2022-04-11 18:30:00+01:00,29,1,28,0,14057.54,-28
2022-04-11 19:30:00+01:00,45,1,44,0,14037.88,-44
2022-04-11 20:30:00+01:00,50,2,48,0,13992.56,-48
2022-04-12 14:30:00+01:00,11,3,8,0,14186.58,-8
2022-04-12 15:30:00+01:00,16,1,15,0,14169.98,-15
2022-04-12 16:30:00+01:00,24,1,23,0,14072.84,-23
2022-04-12 17:30:00+01:00,22,2,20,0,14080.35,-20
2022-04-12 18:30:00+01:00,26,2,24,0,13931.29,-24
2022-04-12 19:30:00+01:00,35,1,34,0,13893.56,-34
2022-04-12 20:30:00+01:00,26,1,25,0,13941.19,-25
2022-04-13 14:30:00+01:00,5,3,2,0,14070.17,-2
2022-04-13 15:30:00+01:00,4,8,0,4,14152.61,4
2022-04-13 16:30:00+01:00,6,6,0,0,14161.33,0
2022-04-13 17:30:00+01:00,5,6,0,1,14177.60,1
2022-04-13 18:30:00+01:00,3,8,0,5,14171.67,5
2022-04-13 19:30:00+01:00,1,9,0,8,14237.83,8
2022-04-13 20:30:00+01:00,0,11,0,11,14218.26,11
2022-04-14 14:30:00+01:00,5,6,0,1,14066.71,1
2022-04-14 15:30:00+01:00,5,4,1,0,14074.39,-1
2022-04-14 16:30:00+01:00,4,7,0,3,13986.64,3
2022-04-14 17:30:00+01:00,4,9,0,5,13977.11,5
2022-04-14 18:30:00+01:00,1,17,0,16,14007.76,16
2022-04-14 19:30:00+01:00,2,15,0,13,13931.42,13
2022-04-14 20:30:00+01:00,3,11,0,8,13892.56,8
2022-04-18 14:30:00+01:00,16,3,13,0,13976.68,-13
2022-04-18 15:30:00+01:00,35,2,33,0,13876.77,-33
2022-04-18 16:30:00+01:00,46,1,45,0,13794.62,-45
2022-04-18 17:30:00+01:00,39,1,38,0,13855.53,-38
2022-04-18 18:30:00+01:00,26,3,23,0,13964.00,-23
2022-04-18 19:30:00+01:00,43,1,42,0,13892.24,-42
2022-04-18 20:30:00+01:00,34,1,33,0,13909.30,-33
2022-04-19 14:30:00+01:00,6,2,4,0,14076.89,-4
2022-04-19 15:30:00+01:00,4,4,0,0,14165.31,0
2022-04-19 16:30:00+01:00,4,8,0,4,14149.36,4
2022-04-19 17:30:00+01:00,5,7,0,2,14125.61,2
2022-04-19 18:30:00+01:00,5,4,1,0,14123.19,-1
2022-04-19 19:30:00+01:00,3,18,0,15,14213.82,15
2022-04-19 20:30:00+01:00,2,27,0,25,14214.79,25
2022-04-20 14:30:00+01:00,1,33,0,32,14100.86,32
2022-04-20 15:30:00+01:00,1,35,0,34,14039.15,34
2022-04-20 16:30:00+01:00,1,45,0,44,13995.04,44
2022-04-20 17:30:00+01:00,1,45,0,44,14074.31,44
2022-04-20 18:30:00+01:00,5,34,0,29,14031.14,29
2022-04-20 19:30:00+01:00,4,40,0,36,14025.68,36
2022-04-20 20:30:00+01:00,6,34,0,28,13996.02,28
2022-04-21 14:30:00+01:00,11,31,0,20,14167.85,20
2022-04-21 15:30:00+01:00,20,17,3,0,14083.51,-3
2022-04-21 16:30:00+01:00,26,12,14,0,13938.37,-14
2022-04-21 17:30:00+01:00,26,15,11,0,13934.91,-11
2022-04-21 18:30:00+01:00,32,11,21,0,13805.32,-21
2022-04-21 19:30:00+01:00,38,4,34,0,13761.95,-34
2022-04-21 20:30:00+01:00,40,2,38,0,13727.30,-38
2022-04-22 14:30:00+01:00,61,1,60,0,13588.63,-60
2022-04-22 15:30:00+01:00,51,1,50,0,13613.71,-50
2022-04-22 16:30:00+01:00,58,0,58,0,13514.06,-58
2022-04-22 17:30:00+01:00,65,2,63,0,13474.42,-63
2022-04-22 18:30:00+01:00,71,0,71,0,13443.61,-71
2022-04-22 19:30:00+01:00,73,2,71,0,13434.03,-71
2022-04-22 20:30:00+01:00,75,1,74,0,13355.70,-74
2022-04-25 14:30:00+01:00,72,1,71,0,13393.61,-71
2022-04-25 15:30:00+01:00,71,1,70,0,13308.72,-70
2022-04-25 16:30:00+01:00,54,2,52,0,13344.45,-52
2022-04-25 17:30:00+01:00,53,0,53,0,13377.90,-53
2022-04-25 18:30:00+01:00,32,3,29,0,13441.94,-29
2022-04-25 19:30:00+01:00,22,0,22,0,13477.98,-22
2022-04-25 20:30:00+01:00,11,3,8,0,13535.07,-8
2022-04-26 14:30:00+01:00,16,0,16,0,13198.64,-16
2022-04-26 15:30:00+01:00,26,1,25,0,13147.09,-25
2022-04-26 16:30:00+01:00,12,2,10,0,13211.08,-10
2022-04-26 17:30:00+01:00,19,4,15,0,13108.92,-15
2022-04-26 18:30:00+01:00,10,1,9,0,13174.02,-9
2022-04-26 19:30:00+01:00,15,0,15,0,13078.44,-15
2022-04-26 20:30:00+01:00,14,0,14,0,13010.14,-14
2022-04-27 14:30:00+01:00,28,4,24,0,12975.78,-24
2022-04-27 15:30:00+01:00,10,6,4,0,13106.20,-4
2022-04-27 16:30:00+01:00,5,4,1,0,13209.14,-1
2022-04-27 17:30:00+01:00,8,4,4,0,13158.27,-4
2022-04-27 18:30:00+01:00,15,2,13,0,13112.65,-13
2022-04-27 19:30:00+01:00,21,3,18,0,13025.70,-18
2022-04-27 20:30:00+01:00,46,1,45,0,12999.72,-45
2022-04-28 14:30:00+01:00,21,2,19,0,13072.51,-19
2022-04-28 15:30:00+01:00,14,4,10,0,13178.66,-10
2022-04-28 16:30:00+01:00,7,5,2,0,13253.29,-2
2022-04-28 17:30:00+01:00,4,14,0,10,13410.23,10
2022-04-28 18:30:00+01:00,4,16,0,12,13457.28,12
2022-04-28 19:30:00+01:00,2,35,0,33,13506.88,33
2022-04-28 20:30:00+01:00,2,43,0,41,13467.14,41
2022-04-29 14:30:00+01:00,4,29,0,25,13233.15,25
2022-04-29 15:30:00+01:00,6,21,0,15,13198.03,15
2022-04-29 16:30:00+01:00,8,10,0,2,13120.54,2
2022-04-29 17:30:00+01:00,8,10,0,2,13108.54,2
2022-04-29 18:30:00+01:00,10,7,3,0,13021.59,-3
2022-04-29 19:30:00+01:00,10,6,4,0,12940.97,-4
2022-04-29 20:30:00+01:00,11,5,6,0,12858.07,-6
2022-05-02 14:30:00+01:00,3,6,0,3,12984.37,3
2022-05-02 15:30:00+01:00,13,3,10,0,12862.32,-10
2022-05-02 16:30:00+01:00,22,4,18,0,12913.36,-18
2022-05-02 17:30:00+01:00,42,2,40,0,12796.44,-40
2022-05-02 18:30:00+01:00,60,2,58,0,12749.58,-58
2022-05-02 19:30:00+01:00,28,2,26,0,12967.72,-26
2022-05-02 20:30:00+01:00,22,2,20,0,13075.21,-20
2022-05-03 14:30:00+01:00,9,0,9,0,13070.65,-9
2022-05-03 15:30:00+01:00,8,0,8,0,13111.46,-8
2022-05-03 16:30:00+01:00,9,1,8,0,13060.45,-8
2022-05-03 17:30:00+01:00,8,0,8,0,13132.24,-8
2022-05-03 18:30:00+01:00,9,1,8,0,13038.44,-8
2022-05-03 19:30:00+01:00,3,2,1,0,13088.13,-1
2022-05-03 20:30:00+01:00,0,6,0,6,13085.98,6
2022-05-04 14:30:00+01:00,9,3,6,0,12962.98,-6
2022-05-04 15:30:00+01:00,8,5,3,0,12909.65,-3
2022-05-04 16:30:00+01:00,3,5,0,2,13059.86,2
2022-05-04 17:30:00+01:00,1,16,0,15,13098.71,15
2022-05-04 18:30:00+01:00,1,28,0,27,13130.52,27
2022-05-04 19:30:00+01:00,0,36,0,36,13466.51,36
2022-05-04 20:30:00+01:00,0,35,0,35,13534.58,35
2022-05-05 14:30:00+01:00,3,6,0,3,13021.08,3
2022-05-05 15:30:00+01:00,3,1,2,0,12914.93,-2
2022-05-05 16:30:00+01:00,3,2,1,0,12909.18,-1
2022-05-05 17:30:00+01:00,3,1,2,0,12904.64,-2
2022-05-05 18:30:00+01:00,3,1,2,0,12797.07,-2
2022-05-05 19:30:00+01:00,6,2,4,0,12729.31,-4
2022-05-05 20:30:00+01:00,3,1,2,0,12869.04,-2
2022-05-06 14:30:00+01:00,2,2,0,0,12719.82,0
2022-05-06 15:30:00+01:00,3,2,1,0,12883.73,-1
2022-05-06 16:30:00+01:00,4,2,2,0,12793.62,-2
2022-05-06 17:30:00+01:00,11,3,8,0,12779.35,-8
2022-05-06 18:30:00+01:00,16,0,16,0,12656.33,-16
2022-05-06 19:30:00+01:00,71,2,69,0,12616.11,-69
2022-05-06 20:30:00+01:00,64,0,64,0,12692.32,-64
2022-05-09 14:30:00+01:00,55,0,55,0,12349.30,-55
2022-05-09 15:30:00+01:00,52,1,51,0,12277.85,-51
2022-05-09 16:30:00+01:00,37,1,36,0,12376.14,-36
2022-05-09 17:30:00+01:00,45,1,44,0,12317.12,-44
2022-05-09 18:30:00+01:00,40,2,38,0,12237.11,-38
2022-05-09 19:30:00+01:00,37,5,32,0,12231.32,-32
2022-05-09 20:30:00+01:00,62,0,62,0,12193.96,-62
2022-05-10 14:30:00+01:00,15,5,10,0,12417.10,-10
2022-05-10 15:30:00+01:00,52,1,51,0,12221.15,-51
2022-05-10 16:30:00+01:00,45,1,44,0,12241.46,-44
2022-05-10 17:30:00+01:00,24,2,22,0,12338.52,-22
2022-05-10 18:30:00+01:00,7,0,7,0,12422.11,-7
2022-05-10 19:30:00+01:00,7,0,7,0,12393.00,-7
2022-05-10 20:30:00+01:00,16,0,16,0,12346.92,-16
2022-05-11 14:30:00+01:00,1,4,0,3,12386.61,3
2022-05-11 15:30:00+01:00,2,5,0,3,12315.45,3
2022-05-11 16:30:00+01:00,9,1,8,0,12210.27,-8
2022-05-11 17:30:00+01:00,12,1,11,0,12092.97,-11
2022-05-11 18:30:00+01:00,9,1,8,0,12082.90,-8
2022-05-11 19:30:00+01:00,11,1,10,0,12012.05,-10
2022-05-11 20:30:00+01:00,11,2,9,0,11971.79,-9
2022-05-12 14:30:00+01:00,18,1,17,0,11979.26,-17
2022-05-12 15:30:00+01:00,6,2,4,0,12037.66,-4
2022-05-12 16:30:00+01:00,10,3,7,0,11905.68,-7
2022-05-12 17:30:00+01:00,22,2,20,0,11849.95,-20
2022-05-12 18:30:00+01:00,45,1,44,0,11756.14,-44
2022-05-12 19:30:00+01:00,37,1,36,0,11821.16,-36
2022-05-12 20:30:00+01:00,21,3,18,0,11949.70,-18
2022-05-13 14:30:00+01:00,0,3,0,3,12323.82,3
2022-05-13 15:30:00+01:00,0,5,0,5,12346.59,5
2022-05-13 16:30:00+01:00,0,13,0,13,12396.46,13
2022-05-13 17:30:00+01:00,0,21,0,21,12361.11,21
2022-05-13 18:30:00+01:00,0,15,0,15,12248.47,15
2022-05-13 19:30:00+01:00,0,37,0,37,12420.19,37
2022-05-13 20:30:00+01:00,0,41,0,41,12384.17,41
2022-05-16 14:30:00+01:00,0,33,0,33,12358.76,33
2022-05-16 15:30:00+01:00,0,10,0,10,12230.86,10
2022-05-16 16:30:00+01:00,0,19,0,19,12273.99,19
2022-05-16 17:30:00+01:00,0,27,0,27,12319.74,27
2022-05-16 18:30:00+01:00,1,52,0,51,12376.43,51
2022-05-16 19:30:00+01:00,0,25,0,25,12275.86,25
2022-05-16 20:30:00+01:00,0,12,0,12,12246.02,12
2022-05-17 14:30:00+01:00,6,6,0,0,12406.97,0
2022-05-17 15:30:00+01:00,3,5,0,2,12436.51,2
2022-05-17 16:30:00+01:00,5,7,0,2,12472.67,2
2022-05-17 17:30:00+01:00,4,9,0,5,12487.51,5
2022-05-17 18:30:00+01:00,5,8,0,3,12423.28,3
2022-05-17 19:30:00+01:00,9,5,4,0,12559.27,-4
2022-05-17 20:30:00+01:00,7,7,0,0,12566.50,0
2022-05-18 14:30:00+01:00,14,3,11,0,12305.83,-11
2022-05-18 15:30:00+01:00,10,5,5,0,12149.06,-5
2022-05-18 16:30:00+01:00,12,4,8,0,12076.04,-8
2022-05-18 17:30:00+01:00,18,4,14,0,12018.67,-14
2022-05-18 18:30:00+01:00,28,1,27,0,11991.99,-27
2022-05-18 19:30:00+01:00,24,0,24,0,11914.12,-24
2022-05-18 20:30:00+01:00,21,0,21,0,11933.48,-21
2022-05-19 14:30:00+01:00,32,2,30,0,11912.54,-30
2022-05-19 15:30:00+01:00,30,2,28,0,11941.22,-28
2022-05-19 16:30:00+01:00,27,3,24,0,12012.93,-24
2022-05-19 17:30:00+01:00,35,3,32,0,11890.91,-32
2022-05-19 18:30:00+01:00,22,2,20,0,11936.44,-20
2022-05-19 19:30:00+01:00,44,0,44,0,11890.23,-44
2022-05-19 20:30:00+01:00,45,0,45,0,11875.77,-45
2022-05-20 14:30:00+01:00,23,3,20,0,11944.27,-20
2022-05-20 15:30:00+01:00,25,2,23,0,11760.06,-23
2022-05-20 16:30:00+01:00,24,1,23,0,11642.41,-23
2022-05-20 17:30:00+01:00,29,1,28,0,11498.02,-28
2022-05-20 18:30:00+01:00,20,1,19,0,11556.89,-19
2022-05-20 19:30:00+01:00,5,3,2,0,11671.27,-2
2022-05-20 20:30:00+01:00,1,4,0,3,11835.84,3
2022-05-23 14:30:00+01:00,0,11,0,11,11880.73,11
2022-05-23 15:30:00+01:00,1,13,0,12,11948.99,12
2022-05-23 16:30:00+01:00,0,10,0,10,12011.46,10
2022-05-23 17:30:00+01:00,0,8,0,8,11952.34,8
2022-05-23 18:30:00+01:00,0,6,0,6,12009.77,6
2022-05-23 19:30:00+01:00,0,6,0,6,11983.77,6
2022-05-23 20:30:00+01:00,0,8,0,8,12030.66,8
2022-05-24 14:30:00+01:00,10,4,6,0,11648.93,-6
2022-05-24 15:30:00+01:00,2,5,0,3,11655.87,3
2022-05-24 16:30:00+01:00,0,12,0,12,11730.79,12
2022-05-24 17:30:00+01:00,0,17,0,17,11676.62,17
2022-05-24 18:30:00+01:00,1,18,0,17,11734.19,17
2022-05-24 19:30:00+01:00,6,14,0,8,11728.27,8
2022-05-24 20:30:00+01:00,11,9,2,0,11778.65,-2
2022-05-25 14:30:00+01:00,4,6,0,2,11883.98,2
2022-05-25 15:30:00+01:00,2,6,0,4,11868.73,4
2022-05-25 16:30:00+01:00,12,4,8,0,11806.34,-8
2022-05-25 17:30:00+01:00,7,7,0,0,11829.44,0
2022-05-25 18:30:00+01:00,6,6,0,0,11934.74,0
2022-05-25 19:30:00+01:00,1,10,0,9,11990.42,9
2022-05-25 20:30:00+01:00,4,8,0,4,11941.91,4
2022-05-26 14:30:00+01:00,0,59,0,59,12154.82,59
2022-05-26 15:30:00+01:00,0,62,0,62,12203.66,62
2022-05-26 16:30:00+01:00,0,60,0,60,12300.81,60
2022-05-26 17:30:00+01:00,0,68,0,68,12287.30,68
2022-05-26 18:30:00+01:00,0,65,0,65,12313.72,65
2022-05-26 19:30:00+01:00,0,55,0,55,12258.06,55
2022-05-26 20:30:00+01:00,1,52,0,51,12272.07,51
2022-05-27 14:30:00+01:00,0,69,0,69,12560.35,69
2022-05-27 15:30:00+01:00,0,71,0,71,12559.88,71
2022-05-27 16:30:00+01:00,0,73,0,73,12579.49,73
2022-05-27 17:30:00+01:00,0,74,0,74,12586.75,74
2022-05-27 18:30:00+01:00,0,68,0,68,12594.82,68
2022-05-27 19:30:00+01:00,1,68,0,67,12654.91,67
2022-05-27 20:30:00+01:00,0,74,0,74,12680.58,74
2022-05-31 14:30:00+01:00,3,37,0,34,12567.05,34
2022-05-31 15:30:00+01:00,2,35,0,33,12591.14,33
2022-05-31 16:30:00+01:00,1,34,0,33,12700.36,33
2022-05-31 17:30:00+01:00,2,31,0,29,12674.09,29
2022-05-31 18:30:00+01:00,0,28,0,28,12730.68,28
2022-05-31 19:30:00+01:00,1,35,0,34,12709.77,34
2022-05-31 20:30:00+01:00,1,26,0,25,12648.77,25
2022-06-01 14:30:00+01:00,12,7,5,0,12617.33,-5
2022-06-01 15:30:00+01:00,17,2,15,0,12553.68,-15
2022-06-01 16:30:00+01:00,23,1,22,0,12487.19,-22
2022-06-01 17:30:00+01:00,18,2,16,0,12523.37,-16
2022-06-01 18:30:00+01:00,10,2,8,0,12630.88,-8
2022-06-01 19:30:00+01:00,16,2,14,0,12624.04,-14
2022-06-01 20:30:00+01:00,23,2,21,0,12546.86,-21
2022-06-02 14:30:00+01:00,11,2,9,0,12518.74,-9
2022-06-02 15:30:00+01:00,6,7,0,1,12671.40,1
2022-06-02 16:30:00+01:00,5,8,0,3,12763.70,3
2022-06-02 17:30:00+01:00,3,11,0,8,12796.54,8
2022-06-02 18:30:00+01:00,3,11,0,8,12844.58,8
2022-06-02 19:30:00+01:00,3,14,0,11,12815.82,11
2022-06-02 20:30:00+01:00,2,21,0,19,12893.46,19
2022-06-03 14:30:00+01:00,1,11,0,10,12635.31,10
2022-06-03 15:30:00+01:00,2,8,0,6,12518.96,6
2022-06-03 16:30:00+01:00,0,12,0,12,12569.14,12
2022-06-03 17:30:00+01:00,0,12,0,12,12575.58,12
2022-06-03 18:30:00+01:00,0,8,0,8,12596.76,8
2022-06-03 19:30:00+01:00,2,6,0,4,12546.22,4
2022-06-03 20:30:00+01:00,1,12,0,11,12545.90,11
2022-06-06 14:30:00+01:00,0,23,0,23,12782.04,23
2022-06-06 15:30:00+01:00,2,6,0,4,12655.73,4
2022-06-06 16:30:00+01:00,4,2,2,0,12557.29,-2
2022-06-06 17:30:00+01:00,8,2,6,0,12582.09,-6
2022-06-06 18:30:00+01:00,14,1,13,0,12594.73,-13
2022-06-06 19:30:00+01:00,16,1,15,0,12563.50,-15
2022-06-06 20:30:00+01:00,22,1,21,0,12599.67,-21
2022-06-07 14:30:00+01:00,12,5,7,0,12588.91,-7
2022-06-07 15:30:00+01:00,6,12,0,6,12597.77,6
2022-06-07 16:30:00+01:00,9,8,1,0,12582.77,-1
2022-06-07 17:30:00+01:00,3,9,0,6,12650.24,6
2022-06-07 18:30:00+01:00,3,11,0,8,12686.87,8
2022-06-07 19:30:00+01:00,3,13,0,10,12689.30,10
2022-06-07 20:30:00+01:00,0,14,0,14,12708.66,14
2022-06-08 14:30:00+01:00,9,9,0,0,12726.22,0
2022-06-08 15:30:00+01:00,5,23,0,18,12758.50,18
2022-06-08 16:30:00+01:00,3,25,0,22,12684.62,22
2022-06-08 17:30:00+01:00,7,16,0,9,12624.73,9
2022-06-08 18:30:00+01:00,9,13,0,4,12604.58,4
2022-06-08 19:30:00+01:00,4,17,0,13,12632.91,13
2022-06-08 20:30:00+01:00,8,13,0,5,12614.09,5
2022-06-09 14:30:00+01:00,5,7,0,2,12640.56,2
2022-06-09 15:30:00+01:00,9,1,8,0,12557.06,-8
2022-06-09 16:30:00+01:00,4,2,2,0,12565.87,-2
2022-06-09 17:30:00+01:00,15,1,14,0,12549.18,-14
2022-06-09 18:30:00+01:00,31,1,30,0,12505.58,-30
2022-06-09 19:30:00+01:00,47,0,47,0,12366.58,-47
2022-06-09 20:30:00+01:00,59,0,59,0,12269.08,-59
2022-06-10 14:30:00+01:00,81,0,81,0,11872.42,-81
2022-06-10 15:30:00+01:00,86,0,86,0,11836.71,-86
2022-06-10 16:30:00+01:00,84,0,84,0,11854.30,-84
2022-06-10 17:30:00+01:00,75,1,74,0,11880.62,-74
2022-06-10 18:30:00+01:00,72,0,72,0,11892.72,-72
2022-06-10 19:30:00+01:00,74,0,74,0,11945.85,-74
2022-06-10 20:30:00+01:00,81,0,81,0,11832.46,-81
2022-06-13 14:30:00+01:00,91,1,90,0,11394.55,-90
2022-06-13 15:30:00+01:00,91,0,91,0,11387.38,-91
2022-06-13 16:30:00+01:00,89,0,89,0,11442.32,-89
2022-06-13 17:30:00+01:00,90,0,90,0,11390.88,-90
2022-06-13 18:30:00+01:00,89,0,89,0,11395.14,-89
2022-06-13 19:30:00+01:00,89,0,89,0,11300.66,-89
2022-06-13 20:30:00+01:00,86,0,86,0,11290.47,-86
2022-06-14 14:30:00+01:00,67,0,67,0,11268.62,-67
2022-06-14 15:30:00+01:00,60,0,60,0,11295.10,-60
2022-06-14 16:30:00+01:00,59,1,58,0,11305.72,-58
2022-06-14 17:30:00+01:00,55,0,55,0,11370.13,-55
2022-06-14 18:30:00+01:00,62,1,61,0,11324.01,-61
2022-06-14 19:30:00+01:00,76,0,76,0,11270.69,-76
2022-06-14 20:30:00+01:00,58,0,58,0,11310.61,-58
2022-06-15 14:30:00+01:00,3,9,0,6,11487.52,6
2022-06-15 15:30:00+01:00,5,12,0,7,11467.98,7
2022-06-15 16:30:00+01:00,5,9,0,4,11528.10,4
2022-06-15 17:30:00+01:00,3,10,0,7,11507.01,7
2022-06-15 18:30:00+01:00,4,7,0,3,11435.83,3
2022-06-15 19:30:00+01:00,0,36,0,36,11696.26,36
2022-06-15 20:30:00+01:00,0,14,0,14,11592.09,14
2022-06-16 14:30:00+01:00,1,0,1,0,11208.71,-1
2022-06-16 15:30:00+01:00,3,2,1,0,11186.27,-1
2022-06-16 16:30:00+01:00,2,3,0,1,11159.73,1
2022-06-16 17:30:00+01:00,4,1,3,0,11183.64,-3
2022-06-16 18:30:00+01:00,7,1,6,0,11064.22,-6
2022-06-16 19:30:00+01:00,3,1,2,0,11130.96,-2
2022-06-16 20:30:00+01:00,3,0,3,0,11126.61,-3
2022-06-17 14:30:00+01:00,20,2,18,0,11162.90,-18
2022-06-17 15:30:00+01:00,7,0,7,0,11254.81,-7
2022-06-17 16:30:00+01:00,13,2,11,0,11226.46,-11
2022-06-17 17:30:00+01:00,5,0,5,0,11315.11,-5
2022-06-17 18:30:00+01:00,3,2,1,0,11320.18,-1
2022-06-17 19:30:00+01:00,31,0,31,0,11312.20,-31
2022-06-17 20:30:00+01:00,27,2,25,0,11261.71,-25
2022-06-21 14:30:00+01:00,1,33,0,32,11597.34,32
2022-06-21 15:30:00+01:00,0,38,0,38,11609.77,38
2022-06-21 16:30:00+01:00,1,34,0,33,11568.23,33
2022-06-21 17:30:00+01:00,1,34,0,33,11579.15,33
2022-06-21 18:30:00+01:00,1,56,0,55,11561.57,55
2022-06-21 19:30:00+01:00,0,51,0,51,11575.85,51
2022-06-21 20:30:00+01:00,1,47,0,46,11545.96,46
2022-06-22 14:30:00+01:00,2,60,0,58,11670.16,58
2022-06-22 15:30:00+01:00,3,47,0,44,11642.05,44
2022-06-22 16:30:00+01:00,2,36,0,34,11581.17,34
2022-06-22 17:30:00+01:00,2,32,0,30,11629.94,30
2022-06-22 18:30:00+01:00,2,34,0,32,11633.32,32
2022-06-22 19:30:00+01:00,3,20,0,17,11568.49,17
2022-06-22 20:30:00+01:00,3,24,0,21,11530.88,21
2022-06-23 14:30:00+01:00,15,20,0,5,11617.03,5
2022-06-23 15:30:00+01:00,10,21,0,11,11676.38,11
2022-06-23 16:30:00+01:00,14,21,0,7,11601.00,7
2022-06-23 17:30:00+01:00,21,15,6,0,11543.32,-6
2022-06-23 18:30:00+01:00,16,26,0,10,11609.39,10
2022-06-23 19:30:00+01:00,11,27,0,16,11660.89,16
2022-06-23 20:30:00+01:00,10,30,0,20,11698.72,20
2022-06-24 14:30:00+01:00,0,41,0,41,12011.54,41
2022-06-24 15:30:00+01:00,0,32,0,32,11969.57,32
2022-06-24 16:30:00+01:00,0,47,0,47,11979.96,47
2022-06-24 17:30:00+01:00,0,42,0,42,11985.64,42
2022-06-24 18:30:00+01:00,0,41,0,41,11995.44,41
2022-06-24 19:30:00+01:00,0,56,0,56,12019.07,56
2022-06-24 20:30:00+01:00,0,65,0,65,12112.16,65
2022-06-27 14:30:00+01:00,1,38,0,37,12012.01,37
2022-06-27 15:30:00+01:00,0,45,0,45,12103.59,45
2022-06-27 16:30:00+01:00,0,40,0,40,12023.93,40
2022-06-27 17:30:00+01:00,0,54,0,54,12040.46,54
2022-06-27 18:30:00+01:00,0,44,0,44,12011.63,44
2022-06-27 19:30:00+01:00,0,40,0,40,12012.73,40
2022-06-27 20:30:00+01:00,0,34,0,34,11982.46,34
2022-06-28 14:30:00+01:00,0,11,0,11,11983.17,11
2022-06-28 15:30:00+01:00,3,5,0,2,11832.40,2
2022-06-28 16:30:00+01:00,13,5,8,0,11773.36,-8
2022-06-28 17:30:00+01:00,18,4,14,0,11740.48,-14
2022-06-28 18:30:00+01:00,21,4,17,0,11696.13,-17
2022-06-28 19:30:00+01:00,29,4,25,0,11676.59,-25
2022-06-28 20:30:00+01:00,54,1,53,0,11637.49,-53
2022-06-29 14:30:00+01:00,38,2,36,0,11655.82,-36
2022-06-29 15:30:00+01:00,63,2,61,0,11639.39,-61
2022-06-29 16:30:00+01:00,61,0,61,0,11576.87,-61
2022-06-29 17:30:00+01:00,58,0,58,0,11617.71,-58
2022-06-29 18:30:00+01:00,48,1,47,0,11671.14,-47
2022-06-29 19:30:00+01:00,49,2,47,0,11683.56,-47
2022-06-29 20:30:00+01:00,47,1,46,0,11659.19,-46
2022-06-30 14:30:00+01:00,71,1,70,0,11358.45,-70
2022-06-30 15:30:00+01:00,22,1,21,0,11548.89,-21
2022-06-30 16:30:00+01:00,5,2,3,0,11619.35,-3
2022-06-30 17:30:00+01:00,5,2,3,0,11580.18,-3
2022-06-30 18:30:00+01:00,4,2,2,0,11574.45,-2
2022-06-30 19:30:00+01:00,5,6,0,1,11521.23,1
2022-06-30 20:30:00+01:00,4,4,0,0,11507.52,0
2022-07-01 14:30:00+01:00,11,6,5,0,11420.92,-5
2022-07-01 15:30:00+01:00,9,8,1,0,11453.13,-1
2022-07-01 16:30:00+01:00,6,7,0,1,11459.28,1
2022-07-01 17:30:00+01:00,8,6,2,0,11446.33,-2
2022-07-01 18:30:00+01:00,6,9,0,3,11516.49,3
2022-07-01 19:30:00+01:00,5,8,0,3,11545.64,3
2022-07-01 20:30:00+01:00,5,12,0,7,11582.17,7
2022-07-05 14:30:00+01:00,3,28,0,25,11471.67,25
2022-07-05 15:30:00+01:00,18,17,1,0,11467.58,-1
2022-07-05 16:30:00+01:00,16,17,0,1,11604.49,1
2022-07-05 17:30:00+01:00,14,23,0,9,11636.41,9
2022-07-05 18:30:00+01:00,9,26,0,17,11684.42,17
2022-07-05 19:30:00+01:00,4,35,0,31,11763.47,31
2022-07-05 20:30:00+01:00,4,41,0,37,11780.98,37
2022-07-06 14:30:00+01:00,1,39,0,38,11786.12,38
2022-07-06 15:30:00+01:00,3,33,0,30,11764.61,30
2022-07-06 16:30:00+01:00,2,35,0,33,11778.16,33
2022-07-06 17:30:00+01:00,1,39,0,38,11808.17,38
2022-07-06 18:30:00+01:00,1,37,0,36,11843.43,36
2022-07-06 19:30:00+01:00,1,41,0,40,11925.54,40
2022-07-06 20:30:00+01:00,0,26,0,26,11852.68,26
2022-07-07 14:30:00+01:00,2,52,0,50,12004.14,50
2022-07-07 15:30:00+01:00,0,64,0,64,12009.44,64
2022-07-07 16:30:00+01:00,0,54,0,54,12062.55,54
2022-07-07 17:30:00+01:00,1,53,0,52,12057.53,52
2022-07-07 18:30:00+01:00,1,51,0,50,12114.10,50
2022-07-07 19:30:00+01:00,1,45,0,44,12113.40,44
2022-07-07 20:30:00+01:00,3,41,0,38,12104.18,38
2022-07-08 14:30:00+01:00,0,40,0,40,12084.88,40
2022-07-08 15:30:00+01:00,0,56,0,56,12174.01,56
2022-07-08 16:30:00+01:00,0,23,0,23,12062.19,23
2022-07-08 17:30:00+01:00,1,24,0,23,12087.63,23
2022-07-08 18:30:00+01:00,1,25,0,24,12135.99,24
2022-07-08 19:30:00+01:00,1,13,0,12,12124.39,12
2022-07-08 20:30:00+01:00,1,24,0,23,12125.84,23
2022-07-11 14:30:00+01:00,8,2,6,0,11884.95,-6
2022-07-11 15:30:00+01:00,9,1,8,0,11910.10,-8
2022-07-11 16:30:00+01:00,15,1,14,0,11900.61,-14
2022-07-11 17:30:00+01:00,8,0,8,0,11950.97,-8
2022-07-11 18:30:00+01:00,16,0,16,0,11918.70,-16
2022-07-11 19:30:00+01:00,21,0,21,0,11870.54,-21
2022-07-11 20:30:00+01:00,20,0,20,0,11860.09,-20
2022-07-12 14:30:00+01:00,30,0,30,0,11808.24,-30
2022-07-12 15:30:00+01:00,32,2,30,0,11890.04,-30
2022-07-12 16:30:00+01:00,20,2,18,0,11875.81,-18
2022-07-12 17:30:00+01:00,29,1,28,0,11851.11,-28
2022-07-12 18:30:00+01:00,34,1,33,0,11847.77,-33
2022-07-12 19:30:00+01:00,45,0,45,0,11722.23,-45
2022-07-12 20:30:00+01:00,42,0,42,0,11746.96,-42
2022-07-13 14:30:00+01:00,34,2,32,0,11634.81,-32
2022-07-13 15:30:00+01:00,27,2,25,0,11717.10,-25
2022-07-13 16:30:00+01:00,19,3,16,0,11744.51,-16
2022-07-13 17:30:00+01:00,22,2,20,0,11783.59,-20
2022-07-13 18:30:00+01:00,20,3,17,0,11775.21,-17
2022-07-13 19:30:00+01:00,18,4,14,0,11761.82,-14
2022-07-13 20:30:00+01:00,21,2,19,0,11726.80,-19
2022-07-14 14:30:00+01:00,35,1,34,0,11528.66,-34
2022-07-14 15:30:00+01:00,32,0,32,0,11624.49,-32
2022-07-14 16:30:00+01:00,29,2,27,0,11626.13,-27
2022-07-14 17:30:00+01:00,20,2,18,0,11679.90,-18
2022-07-14 18:30:00+01:00,19,3,16,0,11771.21,-16
2022-07-14 19:30:00+01:00,7,12,0,5,11791.81,5
2022-07-14 20:30:00+01:00,11,10,1,0,11765.34,-1
2022-07-15 14:30:00+01:00,4,24,0,20,11940.89,20
2022-07-15 15:30:00+01:00,11,19,0,8,11948.84,8
2022-07-15 16:30:00+01:00,9,15,0,6,11925.66,6
2022-07-15 17:30:00+01:00,8,13,0,5,11947.32,5
2022-07-15 18:30:00+01:00,8,12,0,4,11947.50,4
2022-07-15 19:30:00+01:00,4,17,0,13,11949.04,13
2022-07-15 20:30:00+01:00,3,22,0,19,11984.15,19
2022-07-18 14:30:00+01:00,0,71,0,71,12097.47,71
2022-07-18 15:30:00+01:00,0,62,0,62,12112.85,62
2022-07-18 16:30:00+01:00,0,69,0,69,12136.91,69
2022-07-18 17:30:00+01:00,0,65,0,65,12096.25,65
2022-07-18 18:30:00+01:00,2,16,0,14,11953.74,14
2022-07-18 19:30:00+01:00,6,8,0,2,11896.22,2
2022-07-18 20:30:00+01:00,4,7,0,3,11873.65,3
2022-07-19 14:30:00+01:00,2,20,0,18,12056.57,18
2022-07-19 15:30:00+01:00,0,28,0,28,12138.03,28
2022-07-19 16:30:00+01:00,0,28,0,28,12156.19,28
2022-07-19 17:30:00+01:00,1,28,0,27,12171.03,27
2022-07-19 18:30:00+01:00,0,29,0,29,12204.66,29
2022-07-19 19:30:00+01:00,0,33,0,33,12230.98,33
2022-07-19 20:30:00+01:00,1,29,0,28,12245.11,28
2022-07-20 14:30:00+01:00,3,38,0,35,12364.82,35
2022-07-20 15:30:00+01:00,1,42,0,41,12441.56,41
2022-07-20 16:30:00+01:00,4,43,0,39,12458.74,39
2022-07-20 17:30:00+01:00,3,36,0,33,12384.59,33
2022-07-20 18:30:00+01:00,0,64,0,64,12418.74,64
2022-07-20 19:30:00+01:00,0,73,0,73,12468.41,73
2022-07-20 20:30:00+01:00,1,69,0,68,12438.53,68
2022-07-21 14:30:00+01:00,4,53,0,49,12372.87,49
2022-07-21 15:30:00+01:00,3,54,0,51,12480.34,51
2022-07-21 16:30:00+01:00,1,55,0,54,12578.76,54
2022-07-21 17:30:00+01:00,2,53,0,51,12555.99,51
2022-07-21 18:30:00+01:00,4,52,0,48,12585.12,48
2022-07-21 19:30:00+01:00,4,48,0,44,12585.71,44
2022-07-21 20:30:00+01:00,4,51,0,47,12619.10,47
2022-07-22 14:30:00+01:00,2,26,0,24,12554.28,24
2022-07-22 15:30:00+01:00,5,8,0,3,12464.11,3
2022-07-22 16:30:00+01:00,9,6,3,0,12402.08,-3
2022-07-22 17:30:00+01:00,8,8,0,0,12368.02,0
2022-07-22 18:30:00+01:00,9,2,7,0,12341.51,-7
2022-07-22 19:30:00+01:00,10,3,7,0,12400.05,-7
2022-07-22 20:30:00+01:00,10,5,5,0,12398.33,-5
2022-07-25 14:30:00+01:00,11,8,3,0,12306.19,-3
2022-07-25 15:30:00+01:00,17,7,10,0,12331.00,-10
2022-07-25 16:30:00+01:00,28,6,22,0,12330.79,-22
2022-07-25 17:30:00+01:00,25,8,17,0,12335.33,-17
2022-07-25 18:30:00+01:00,36,5,31,0,12286.74,-31
2022-07-25 19:30:00+01:00,38,4,34,0,12257.82,-34
2022-07-25 20:30:00+01:00,31,5,26,0,12326.20,-26
2022-07-26 14:30:00+01:00,47,4,43,0,12159.94,-43
2022-07-26 15:30:00+01:00,42,5,37,0,12123.82,-37
2022-07-26 16:30:00+01:00,32,6,26,0,12108.90,-26
2022-07-26 17:30:00+01:00,27,9,18,0,12129.15,-18
2022-07-26 18:30:00+01:00,28,8,20,0,12070.18,-20
2022-07-26 19:30:00+01:00,40,9,31,0,12071.58,-31
2022-07-26 20:30:00+01:00,41,7,34,0,12083.07,-34
2022-07-27 14:30:00+01:00,5,12,0,7,12384.23,7
2022-07-27 15:30:00+01:00,5,6,0,1,12398.49,1
2022-07-27 16:30:00+01:00,4,6,0,2,12439.36,2
2022-07-27 17:30:00+01:00,5,6,0,1,12414.49,1
2022-07-27 18:30:00+01:00,5,12,0,7,12433.30,7
2022-07-27 19:30:00+01:00,0,37,0,37,12651.21,37
2022-07-27 20:30:00+01:00,2,14,0,12,12594.87,12
2022-07-28 14:30:00+01:00,2,25,0,23,12453.62,23
2022-07-28 15:30:00+01:00,1,51,0,50,12640.98,50
2022-07-28 16:30:00+01:00,3,47,0,44,12647.50,44
2022-07-28 17:30:00+01:00,4,50,0,46,12664.94,46
2022-07-28 18:30:00+01:00,1,62,0,61,12686.46,61
2022-07-28 19:30:00+01:00,1,68,0,67,12726.97,67
2022-07-28 20:30:00+01:00,1,68,0,67,12713.97,67
2022-07-29 14:30:00+01:00,2,55,0,53,12898.39,53
2022-07-29 15:30:00+01:00,5,38,0,33,12780.16,33
2022-07-29 16:30:00+01:00,4,38,0,34,12838.94,34
2022-07-29 17:30:00+01:00,4,49,0,45,12871.36,45
2022-07-29 18:30:00+01:00,3,49,0,46,12929.66,46
2022-07-29 19:30:00+01:00,4,36,0,32,12969.33,32
2022-07-29 20:30:00+01:00,6,45,0,39,12945.32,39
2022-08-01 14:30:00+01:00,0,48,0,48,12960.33,48
2022-08-01 15:30:00+01:00,5,36,0,31,13051.02,31
2022-08-01 16:30:00+01:00,3,30,0,27,13013.29,27
2022-08-01 17:30:00+01:00,3,17,0,14,12920.02,14
2022-08-01 18:30:00+01:00,8,14,0,6,12929.48,6
2022-08-01 19:30:00+01:00,6,12,0,6,12926.91,6
2022-08-01 20:30:00+01:00,3,15,0,12,12941.91,12
2022-08-02 14:30:00+01:00,3,4,0,1,12880.99,1
2022-08-02 15:30:00+01:00,0,20,0,20,12946.90,20
2022-08-02 16:30:00+01:00,0,27,0,27,13053.62,27
2022-08-02 17:30:00+01:00,0,12,0,12,12973.41,12
2022-08-02 18:30:00+01:00,0,13,0,13,12959.60,13
2022-08-02 19:30:00+01:00,0,10,0,10,12940.23,10
2022-08-02 20:30:00+01:00,0,4,0,4,12901.09,4
2022-08-03 14:30:00+01:00,4,18,0,14,13109.38,14
2022-08-03 15:30:00+01:00,2,13,0,11,13161.14,11
2022-08-03 16:30:00+01:00,1,20,0,19,13189.67,19
2022-08-03 17:30:00+01:00,1,30,0,29,13247.92,29
2022-08-03 18:30:00+01:00,1,37,0,36,13262.42,36
2022-08-03 19:30:00+01:00,2,35,0,33,13252.46,33
2022-08-03 20:30:00+01:00,2,28,0,26,13252.78,26
2022-08-04 14:30:00+01:00,2,39,0,37,13226.96,37
2022-08-04 15:30:00+01:00,5,25,0,20,13203.26,20
2022-08-04 16:30:00+01:00,3,24,0,21,13291.10,21
2022-08-04 17:30:00+01:00,2,30,0,28,13283.36,28
2022-08-04 18:30:00+01:00,3,38,0,35,13283.23,35
2022-08-04 19:30:00+01:00,4,44,0,40,13312.90,40
2022-08-04 20:30:00+01:00,1,50,0,49,13310.75,49
2022-08-05 14:30:00+01:00,6,30,0,24,13251.35,24
2022-08-05 15:30:00+01:00,14,3,11,0,13074.32,-11
2022-08-05 16:30:00+01:00,12,7,5,0,13146.72,-5
2022-08-05 17:30:00+01:00,11,5,6,0,13194.23,-6
2022-08-05 18:30:00+01:00,16,6,10,0,13137.87,-10
2022-08-05 19:30:00+01:00,10,6,4,0,13168.79,-4
2022-08-05 20:30:00+01:00,9,9,0,0,13206.72,0
2022-08-08 14:30:00+01:00,5,18,0,13,13334.45,13
2022-08-08 15:30:00+01:00,6,18,0,12,13262.63,12
2022-08-08 16:30:00+01:00,13,5,8,0,13152.23,-8
2022-08-08 17:30:00+01:00,9,5,4,0,13171.81,-4
2022-08-08 18:30:00+01:00,11,3,8,0,13137.60,-8
2022-08-08 19:30:00+01:00,10,4,6,0,13142.55,-6
2022-08-08 20:30:00+01:00,9,3,6,0,13160.24,-6
2022-08-09 14:30:00+01:00,20,7,13,0,13001.18,-13
2022-08-09 15:30:00+01:00,6,12,0,6,13026.21,6
2022-08-09 16:30:00+01:00,23,6,17,0,12947.73,-17
2022-08-09 17:30:00+01:00,24,3,21,0,12986.39,-21
2022-08-09 18:30:00+01:00,22,1,21,0,12974.91,-21
2022-08-09 19:30:00+01:00,19,3,16,0,13025.55,-16
2022-08-09 20:30:00+01:00,27,1,26,0,13008.95,-26
2022-08-10 14:30:00+01:00,10,0,10,0,13261.80,-10
2022-08-10 15:30:00+01:00,4,1,3,0,13332.58,-3
2022-08-10 16:30:00+01:00,2,11,0,9,13316.07,9
2022-08-10 17:30:00+01:00,2,11,0,9,13329.48,9
2022-08-10 18:30:00+01:00,1,12,0,11,13340.77,11
2022-08-10 19:30:00+01:00,2,15,0,13,13358.20,13
2022-08-10 20:30:00+01:00,2,18,0,16,13373.54,16
2022-08-11 14:30:00+01:00,0,61,0,61,13505.89,61
2022-08-11 15:30:00+01:00,0,35,0,35,13397.13,35
2022-08-11 16:30:00+01:00,1,43,0,42,13385.40,42
2022-08-11 17:30:00+01:00,2,47,0,45,13397.69,45
2022-08-11 18:30:00+01:00,1,34,0,33,13338.93,33
2022-08-11 19:30:00+01:00,1,17,0,16,13300.41,16
2022-08-11 20:30:00+01:00,2,23,0,21,13292.09,21
2022-08-12 14:30:00+01:00,3,13,0,10,13412.53,10
2022-08-12 15:30:00+01:00,3,9,0,6,13449.10,6
2022-08-12 16:30:00+01:00,2,14,0,12,13475.41,12
2022-08-12 17:30:00+01:00,1,13,0,12,13481.33,12
2022-08-12 18:30:00+01:00,0,15,0,15,13498.40,15
2022-08-12 19:30:00+01:00,1,16,0,15,13542.31,15
2022-08-12 20:30:00+01:00,2,14,0,12,13563.02,12
2022-08-15 14:30:00+01:00,9,9,0,0,13548.68,0
2022-08-15 15:30:00+01:00,2,22,0,20,13570.91,20
2022-08-15 16:30:00+01:00,2,34,0,32,13635.40,32
2022-08-15 17:30:00+01:00,1,32,0,31,13648.43,31
2022-08-15 18:30:00+01:00,1,43,0,42,13634.72,42
2022-08-15 19:30:00+01:00,1,63,0,62,13682.38,62
2022-08-15 20:30:00+01:00,0,65,0,65,13662.61,65
2022-08-16 14:30:00+01:00,5,30,0,25,13550.23,25
2022-08-16 15:30:00+01:00,2,28,0,26,13612.12,26
2022-08-16 16:30:00+01:00,1,26,0,25,13635.80,25
2022-08-16 17:30:00+01:00,1,29,0,28,13649.91,28
2022-08-16 18:30:00+01:00,2,30,0,28,13692.06,28
2022-08-16 19:30:00+01:00,1,17,0,16,13625.77,16
2022-08-16 20:30:00+01:00,2,16,0,14,13635.28,14
2022-08-17 14:30:00+01:00,10,5,5,0,13469.02,-5
2022-08-17 15:30:00+01:00,19,6,13,0,13440.44,-13
2022-08-17 16:30:00+01:00,32,2,30,0,13444.19,-30
2022-08-17 17:30:00+01:00,26,1,25,0,13476.09,-25
2022-08-17 18:30:00+01:00,12,5,7,0,13553.94,-7
2022-08-17 19:30:00+01:00,25,2,23,0,13497.06,-23
2022-08-17 20:30:00+01:00,24,2,22,0,13467.56,-22
2022-08-18 14:30:00+01:00,15,2,13,0,13451.56,-13
2022-08-18 15:30:00+01:00,10,2,8,0,13531.46,-8
2022-08-18 16:30:00+01:00,19,2,17,0,13495.29,-17
2022-08-18 17:30:00+01:00,15,2,13,0,13523.25,-13
2022-08-18 18:30:00+01:00,28,2,26,0,13515.43,-26
2022-08-18 19:30:00+01:00,17,6,11,0,13541.24,-11
2022-08-18 20:30:00+01:00,20,4,16,0,13506.68,-16
2022-08-19 14:30:00+01:00,25,2,23,0,13276.05,-23
2022-08-19 15:30:00+01:00,23,2,21,0,13248.05,-21
2022-08-19 16:30:00+01:00,25,2,23,0,13252.08,-23
2022-08-19 17:30:00+01:00,25,2,23,0,13244.49,-23
2022-08-19 18:30:00+01:00,48,1,47,0,13240.61,-47
2022-08-19 19:30:00+01:00,32,1,31,0,13250.40,-31
2022-08-19 20:30:00+01:00,33,2,31,0,13243.09,-31
2022-08-22 14:30:00+01:00,68,3,65,0,12963.01,-65
2022-08-22 15:30:00+01:00,76,0,76,0,12941.23,-76
2022-08-22 16:30:00+01:00,72,2,70,0,12961.81,-70
2022-08-22 17:30:00+01:00,76,2,74,0,12928.03,-74
2022-08-22 18:30:00+01:00,81,1,80,0,12904.39,-80
2022-08-22 19:30:00+01:00,81,0,81,0,12889.26,-81
2022-08-22 20:30:00+01:00,80,1,79,0,12892.51,-79
2022-08-23 14:30:00+01:00,58,5,53,0,12939.91,-53
2022-08-23 15:30:00+01:00,56,5,51,0,12896.06,-51
2022-08-23 16:30:00+01:00,62,6,56,0,12870.12,-56
2022-08-23 17:30:00+01:00,54,5,49,0,12933.56,-49
2022-08-23 18:30:00+01:00,54,4,50,0,12929.97,-50
2022-08-23 19:30:00+01:00,58,5,53,0,12911.59,-53
2022-08-23 20:30:00+01:00,60,5,55,0,12878.06,-55
2022-08-24 14:30:00+01:00,19,11,8,0,12922.10,-8
2022-08-24 15:30:00+01:00,13,13,0,0,12972.28,0
2022-08-24 16:30:00+01:00,11,12,0,1,12968.96,1
2022-08-24 17:30:00+01:00,12,7,5,0,12900.75,-5
2022-08-24 18:30:00+01:00,6,9,0,3,12928.32,3
2022-08-24 19:30:00+01:00,3,9,0,6,12936.96,6
2022-08-24 20:30:00+01:00,5,9,0,4,12913.89,4
2022-08-25 14:30:00+01:00,2,19,0,17,13080.32,17
2022-08-25 15:30:00+01:00,2,12,0,10,13012.59,10
2022-08-25 16:30:00+01:00,2,17,0,15,13022.51,15
2022-08-25 17:30:00+01:00,2,17,0,15,13042.17,15
2022-08-25 18:30:00+01:00,2,22,0,20,13071.03,20
2022-08-25 19:30:00+01:00,2,26,0,24,13074.76,24
2022-08-25 20:30:00+01:00,0,48,0,48,13145.59,48
2022-08-26 14:30:00+01:00,2,6,0,4,12974.43,4
2022-08-26 15:30:00+01:00,7,5,2,0,12814.77,-2
2022-08-26 16:30:00+01:00,6,5,1,0,12767.97,-1
2022-08-26 17:30:00+01:00,2,4,0,2,12772.47,2
2022-08-26 18:30:00+01:00,9,3,6,0,12712.04,-6
2022-08-26 19:30:00+01:00,14,3,11,0,12673.14,-11
2022-08-26 20:30:00+01:00,20,2,18,0,12606.37,-18
2022-08-29 14:30:00+01:00,67,1,66,0,12559.50,-66
2022-08-29 15:30:00+01:00,67,1,66,0,12457.26,-66
2022-08-29 16:30:00+01:00,61,2,59,0,12520.94,-59
2022-08-29 17:30:00+01:00,57,0,57,0,12544.06,-57
2022-08-29 18:30:00+01:00,68,1,67,0,12528.79,-67
2022-08-29 19:30:00+01:00,68,0,68,0,12542.22,-68
2022-08-29 20:30:00+01:00,78,0,78,0,12481.56,-78
2022-08-30 14:30:00+01:00,77,0,77,0,12397.17,-77
2022-08-30 15:30:00+01:00,69,1,68,0,12335.95,-68
2022-08-30 16:30:00+01:00,68,1,67,0,12335.94,-67
2022-08-30 17:30:00+01:00,76,0,76,0,12270.20,-76
2022-08-30 18:30:00+01:00,69,2,67,0,12279.81,-67
2022-08-30 19:30:00+01:00,51,1,50,0,12343.37,-50
2022-08-30 20:30:00+01:00,35,1,34,0,12343.56,-34
2022-08-31 14:30:00+01:00,27,2,25,0,12373.77,-25
2022-08-31 15:30:00+01:00,26,1,25,0,12322.31,-25
2022-08-31 16:30:00+01:00,29,3,26,0,12355.42,-26
2022-08-31 17:30:00+01:00,43,0,43,0,12311.79,-43
2022-08-31 18:30:00+01:00,34,0,34,0,12318.06,-34
2022-08-31 19:30:00+01:00,28,3,25,0,12326.61,-25
2022-08-31 20:30:00+01:00,25,5,20,0,12271.38,-20
2022-09-01 14:30:00+01:00,34,3,31,0,12155.52,-31
2022-09-01 15:30:00+01:00,35,2,33,0,12025.06,-33
2022-09-01 16:30:00+01:00,29,4,25,0,12058.61,-25
2022-09-01 17:30:00+01:00,15,4,11,0,12109.53,-11
2022-09-01 18:30:00+01:00,11,3,8,0,12164.92,-8
2022-09-01 19:30:00+01:00,12,4,8,0,12187.42,-8
2022-09-01 20:30:00+01:00,8,7,1,0,12282.41,-1
2022-09-02 14:30:00+01:00,5,11,0,6,12395.76,6
2022-09-02 15:30:00+01:00,3,12,0,9,12408.29,9
2022-09-02 16:30:00+01:00,4,5,0,1,12305.36,1
2022-09-02 17:30:00+01:00,8,2,6,0,12133.04,-6
2022-09-02 18:30:00+01:00,7,3,4,0,12135.47,-4
2022-09-02 19:30:00+01:00,11,3,8,0,12103.66,-8
2022-09-02 20:30:00+01:00,9,2,7,0,12103.61,-7
2022-09-06 14:30:00+01:00,9,2,7,0,11994.71,-7
2022-09-06 15:30:00+01:00,2,6,0,4,12065.74,4
2022-09-06 16:30:00+01:00,5,5,0,0,12038.18,0
2022-09-06 17:30:00+01:00,9,3,6,0,11978.29,-6
2022-09-06 18:30:00+01:00,6,5,1,0,12034.20,-1
2022-09-06 19:30:00+01:00,10,4,6,0,12029.71,-6
2022-09-06 20:30:00+01:00,21,4,17,0,12012.10,-17
2022-09-07 14:30:00+01:00,30,2,28,0,12065.85,-28
2022-09-07 15:30:00+01:00,29,3,26,0,12121.24,-26
2022-09-07 16:30:00+01:00,17,7,10,0,12111.27,-10
2022-09-07 17:30:00+01:00,4,17,0,13,12145.87,13
2022-09-07 18:30:00+01:00,3,19,0,16,12238.73,16
2022-09-07 19:30:00+01:00,0,31,0,31,12295.56,31
2022-09-07 20:30:00+01:00,1,27,0,26,12258.07,26
2022-09-08 14:30:00+01:00,3,39,0,36,12248.75,36
2022-09-08 15:30:00+01:00,0,44,0,44,12356.01,44
2022-09-08 16:30:00+01:00,1,19,0,18,12173.54,18
2022-09-08 17:30:00+01:00,0,46,0,46,12272.08,46
2022-09-08 18:30:00+01:00,0,33,0,33,12261.34,33
2022-09-08 19:30:00+01:00,0,35,0,35,12275.03,35
2022-09-08 20:30:00+01:00,0,42,0,42,12321.02,42
2022-09-09 14:30:00+01:00,0,50,0,50,12521.16,50
2022-09-09 15:30:00+01:00,0,50,0,50,12555.45,50
2022-09-09 16:30:00+01:00,0,44,0,44,12526.63,44
2022-09-09 17:30:00+01:00,0,47,0,47,12583.23,47
2022-09-09 18:30:00+01:00,0,39,0,39,12594.03,39
2022-09-09 19:30:00+01:00,0,34,0,34,12592.05,34
2022-09-09 20:30:00+01:00,0,39,0,39,12587.98,39
2022-09-12 14:30:00+01:00,0,58,0,58,12737.46,58
2022-09-12 15:30:00+01:00,1,35,0,34,12728.66,34
2022-09-12 16:30:00+01:00,0,67,0,67,12683.82,67
2022-09-12 17:30:00+01:00,1,60,0,59,12729.86,59
2022-09-12 18:30:00+01:00,2,51,0,49,12691.45,49
2022-09-12 19:30:00+01:00,3,56,0,53,12714.46,53
2022-09-12 20:30:00+01:00,1,55,0,54,12739.48,54
2022-09-13 14:30:00+01:00,23,2,21,0,12295.50,-21
2022-09-13 15:30:00+01:00,36,0,36,0,12193.08,-36
2022-09-13 16:30:00+01:00,33,2,31,0,12206.11,-31
2022-09-13 17:30:00+01:00,29,1,28,0,12252.17,-28
2022-09-13 18:30:00+01:00,45,2,43,0,12174.95,-43
2022-09-13 19:30:00+01:00,57,1,56,0,12075.61,-56
2022-09-13 20:30:00+01:00,55,0,55,0,12034.82,-55
2022-09-14 14:30:00+01:00,80,0,80,0,12026.96,-80
2022-09-14 15:30:00+01:00,64,0,64,0,12117.65,-64
2022-09-14 16:30:00+01:00,60,1,59,0,12123.53,-59
2022-09-14 17:30:00+01:00,60,1,59,0,12137.26,-59
2022-09-14 18:30:00+01:00,61,0,61,0,12072.23,-61
2022-09-14 19:30:00+01:00,70,0,70,0,12044.16,-70
2022-09-14 20:30:00+01:00,62,0,62,0,12139.12,-62
2022-09-15 14:30:00+01:00,31,2,29,0,12038.78,-29
2022-09-15 15:30:00+01:00,26,4,22,0,11972.51,-22
2022-09-15 16:30:00+01:00,30,3,27,0,11939.59,-27
2022-09-15 17:30:00+01:00,16,2,14,0,12058.36,-14
2022-09-15 18:30:00+01:00,15,1,14,0,11982.08,-14
2022-09-15 19:30:00+01:00,13,0,13,0,11874.26,-13
2022-09-15 20:30:00+01:00,5,2,3,0,11929.36,-3
2022-09-16 14:30:00+01:00,14,0,14,0,11773.22,-14
2022-09-16 15:30:00+01:00,25,0,25,0,11748.23,-25
2022-09-16 16:30:00+01:00,34,0,34,0,11718.41,-34
2022-09-16 17:30:00+01:00,39,0,39,0,11746.29,-39
2022-09-16 18:30:00+01:00,16,1,15,0,11799.54,-15
2022-09-16 19:30:00+01:00,13,2,11,0,11824.17,-11
2022-09-16 20:30:00+01:00,21,2,19,0,11857.98,-19
2022-09-19 14:30:00+01:00,23,0,23,0,11845.07,-23
2022-09-19 15:30:00+01:00,13,0,13,0,11838.02,-13
2022-09-19 16:30:00+01:00,12,0,12,0,11812.17,-12
2022-09-19 17:30:00+01:00,24,0,24,0,11870.74,-24
2022-09-19 18:30:00+01:00,17,1,16,0,11847.26,-16
2022-09-19 19:30:00+01:00,1,11,0,10,11938.55,10
2022-09-19 20:30:00+01:00,5,10,0,5,11954.78,5
2022-09-20 14:30:00+01:00,2,10,0,8,11860.48,8
2022-09-20 15:30:00+01:00,2,14,0,12,11904.33,12
2022-09-20 16:30:00+01:00,3,19,0,16,11895.10,16
2022-09-20 17:30:00+01:00,4,7,0,3,11815.27,3
2022-09-20 18:30:00+01:00,5,4,1,0,11814.79,-1
2022-09-20 19:30:00+01:00,5,5,0,0,11860.64,0
2022-09-20 20:30:00+01:00,8,2,6,0,11851.95,-6
2022-09-21 14:30:00+01:00,3,9,0,6,11927.82,6
2022-09-21 15:30:00+01:00,1,6,0,5,11895.49,5
2022-09-21 16:30:00+01:00,1,9,0,8,11921.88,8
2022-09-21 17:30:00+01:00,4,7,0,3,11911.26,3
2022-09-21 18:30:00+01:00,8,1,7,0,11783.81,-7
2022-09-21 19:30:00+01:00,21,0,21,0,11789.18,-21
2022-09-21 20:30:00+01:00,39,0,39,0,11636.61,-39
2022-09-22 14:30:00+01:00,45,0,45,0,11534.60,-45
2022-09-22 15:30:00+01:00,54,0,54,0,11477.70,-54
2022-09-22 16:30:00+01:00,47,0,47,0,11513.36,-47
2022-09-22 17:30:00+01:00,42,1,41,0,11504.05,-41
2022-09-22 18:30:00+01:00,46,0,46,0,11476.72,-46
2022-09-22 19:30:00+01:00,38,0,38,0,11560.14,-38
2022-09-22 20:30:00+01:00,44,0,44,0,11498.76,-44
2022-09-23 14:30:00+01:00,82,0,82,0,11337.60,-82
2022-09-23 15:30:00+01:00,83,0,83,0,11315.80,-83
2022-09-23 16:30:00+01:00,87,0,87,0,11242.96,-87
2022-09-23 17:30:00+01:00,86,0,86,0,11258.43,-86
2022-09-23 18:30:00+01:00,82,0,82,0,11220.53,-82
2022-09-23 19:30:00+01:00,71,0,71,0,11258.98,-71
2022-09-23 20:30:00+01:00,41,1,40,0,11317.04,-40
2022-09-26 14:30:00+01:00,6,1,5,0,11459.68,-5
2022-09-26 15:30:00+01:00,9,0,9,0,11317.12,-9
2022-09-26 16:30:00+01:00,23,0,23,0,11269.67,-23
2022-09-26 17:30:00+01:00,18,0,18,0,11261.22,-18
2022-09-26 18:30:00+01:00,19,0,19,0,11265.96,-19
2022-09-26 19:30:00+01:00,22,0,22,0,11313.64,-22
2022-09-26 20:30:00+01:00,22,1,21,0,11249.82,-21
2022-09-27 14:30:00+01:00,6,3,3,0,11375.28,-3
2022-09-27 15:30:00+01:00,6,3,3,0,11318.70,-3
2022-09-27 16:30:00+01:00,4,0,4,0,11217.32,-4
2022-09-27 17:30:00+01:00,7,0,7,0,11216.61,-7
2022-09-27 18:30:00+01:00,6,1,5,0,11216.96,-5
2022-09-27 19:30:00+01:00,8,1,7,0,11247.31,-7
2022-09-27 20:30:00+01:00,11,0,11,0,11273.93,-11
2022-09-28 14:30:00+01:00,8,1,7,0,11336.46,-7
2022-09-28 15:30:00+01:00,4,6,0,2,11365.95,2
2022-09-28 16:30:00+01:00,1,27,0,26,11403.86,26
2022-09-28 17:30:00+01:00,1,30,0,29,11433.08,29
2022-09-28 18:30:00+01:00,1,28,0,27,11433.05,27
2022-09-28 19:30:00+01:00,1,30,0,29,11497.71,29
2022-09-28 20:30:00+01:00,2,49,0,47,11488.58,47
2022-09-29 14:30:00+01:00,12,3,9,0,11144.17,-9
2022-09-29 15:30:00+01:00,10,4,6,0,11159.86,-6
2022-09-29 16:30:00+01:00,7,13,0,6,11149.38,6
2022-09-29 17:30:00+01:00,7,9,0,2,11119.73,2
2022-09-29 18:30:00+01:00,11,5,6,0,11077.59,-6
2022-09-29 19:30:00+01:00,11,5,6,0,11103.51,-6
2022-09-29 20:30:00+01:00,9,6,3,0,11169.95,-3
2022-09-30 14:30:00+01:00,8,2,6,0,11200.36,-6
2022-09-30 15:30:00+01:00,5,3,2,0,11273.37,-2
2022-09-30 16:30:00+01:00,13,1,12,0,11170.58,-12
2022-09-30 17:30:00+01:00,13,1,12,0,11170.32,-12
2022-09-30 18:30:00+01:00,19,0,19,0,11105.35,-19
2022-09-30 19:30:00+01:00,41,1,40,0,11068.56,-40
2022-09-30 20:30:00+01:00,48,0,48,0,10974.55,-48
2022-10-03 14:30:00+01:00,2,5,0,3,11147.82,3
2022-10-03 15:30:00+01:00,3,4,0,1,11166.55,1
2022-10-03 16:30:00+01:00,5,2,3,0,11131.32,-3
2022-10-03 17:30:00+01:00,3,6,0,3,11190.80,3
2022-10-03 18:30:00+01:00,1,15,0,14,11264.69,14
2022-10-03 19:30:00+01:00,1,13,0,12,11285.15,12
2022-10-03 20:30:00+01:00,2,3,0,1,11228.69,1
2022-10-04 14:30:00+01:00,0,32,0,32,11566.15,32
2022-10-04 15:30:00+01:00,0,26,0,26,11591.42,26
2022-10-04 16:30:00+01:00,1,59,0,58,11581.25,58
2022-10-04 17:30:00+01:00,1,29,0,28,11502.14,28
2022-10-04 18:30:00+01:00,0,53,0,53,11524.85,53
2022-10-04 19:30:00+01:00,0,68,0,68,11550.49,68
2022-10-04 20:30:00+01:00,0,82,0,82,11581.61,82
2022-10-05 14:30:00+01:00,0,16,0,16,11333.10,16
2022-10-05 15:30:00+01:00,1,17,0,16,11368.19,16
2022-10-05 16:30:00+01:00,1,36,0,35,11454.28,35
2022-10-05 17:30:00+01:00,0,37,0,37,11537.92,37
2022-10-05 18:30:00+01:00,1,28,0,27,11549.07,27
2022-10-05 19:30:00+01:00,1,33,0,32,11609.72,32
2022-10-05 20:30:00+01:00,0,35,0,35,11565.36,35
2022-10-06 14:30:00+01:00,6,4,2,0,11476.73,-2
2022-10-06 15:30:00+01:00,3,5,0,2,11589.10,2
2022-10-06 16:30:00+01:00,6,3,3,0,11543.14,-3
2022-10-06 17:30:00+01:00,5,6,0,1,11572.23,1
2022-10-06 18:30:00+01:00,6,2,4,0,11530.02,-4
2022-10-06 19:30:00+01:00,6,2,4,0,11517.74,-4
2022-10-06 20:30:00+01:00,7,3,4,0,11484.63,-4
2022-10-07 14:30:00+01:00,6,1,5,0,11190.63,-5
2022-10-07 15:30:00+01:00,10,1,9,0,11155.34,-9
2022-10-07 16:30:00+01:00,37,1,36,0,11094.03,-36
2022-10-07 17:30:00+01:00,62,1,61,0,11079.67,-61
2022-10-07 18:30:00+01:00,66,1,65,0,11043.93,-65
2022-10-07 19:30:00+01:00,77,1,76,0,11016.40,-76
2022-10-07 20:30:00+01:00,72,1,71,0,11041.29,-71
2022-10-10 14:30:00+01:00,51,3,48,0,10985.71,-48
2022-10-10 15:30:00+01:00,72,1,71,0,10913.22,-71
2022-10-10 16:30:00+01:00,75,1,74,0,10865.57,-74
2022-10-10 17:30:00+01:00,75,1,74,0,10877.74,-74
2022-10-10 18:30:00+01:00,65,0,65,0,10944.77,-65
2022-10-10 19:30:00+01:00,64,0,64,0,10952.85,-64
2022-10-10 20:30:00+01:00,63,0,63,0,10924.91,-63
2022-10-11 14:30:00+01:00,63,1,62,0,10778.53,-62
2022-10-11 15:30:00+01:00,39,3,36,0,10853.93,-36
2022-10-11 16:30:00+01:00,27,5,22,0,10915.93,-22
2022-10-11 17:30:00+01:00,28,5,23,0,10903.30,-23
2022-10-11 18:30:00+01:00,24,8,16,0,10896.96,-16
2022-10-11 19:30:00+01:00,30,6,24,0,10757.97,-24
2022-10-11 20:30:00+01:00,27,3,24,0,10793.59,-24
2022-10-12 14:30:00+01:00,26,4,22,0,10812.08,-22
2022-10-12 15:30:00+01:00,14,7,7,0,10833.37,-7
2022-10-12 16:30:00+01:00,14,6,8,0,10809.80,-8
2022-10-12 17:30:00+01:00,12,4,8,0,10820.98,-8
2022-10-12 18:30:00+01:00,18,6,12,0,10854.71,-12
2022-10-12 19:30:00+01:00,21,3,18,0,10809.12,-18
2022-10-12 20:30:00+01:00,23,2,21,0,10784.56,-21
2022-10-13 14:30:00+01:00,27,0,27,0,10568.25,-27
2022-10-13 15:30:00+01:00,5,2,3,0,10871.85,-3
2022-10-13 16:30:00+01:00,8,2,6,0,10879.24,-6
2022-10-13 17:30:00+01:00,0,2,0,2,11015.22,2
2022-10-13 18:30:00+01:00,2,1,1,0,10958.59,-1
2022-10-13 19:30:00+01:00,0,12,0,12,11042.34,12
2022-10-13 20:30:00+01:00,1,8,0,7,11030.86,7
2022-10-14 14:30:00+01:00,1,3,0,2,10871.69,2
2022-10-14 15:30:00+01:00,1,3,0,2,10871.60,2
2022-10-14 16:30:00+01:00,1,2,0,1,10784.11,1
2022-10-14 17:30:00+01:00,3,2,1,0,10776.81,-1
2022-10-14 18:30:00+01:00,4,1,3,0,10743.96,-3
2022-10-14 19:30:00+01:00,4,1,3,0,10741.73,-3
2022-10-14 20:30:00+01:00,4,1,3,0,10695.38,-3
2022-10-17 14:30:00+01:00,0,32,0,32,11037.08,32
2022-10-17 15:30:00+01:00,0,11,0,11,11036.91,11
2022-10-17 16:30:00+01:00,1,6,0,5,11051.52,5
2022-10-17 17:30:00+01:00,5,2,3,0,11054.18,-3
2022-10-17 18:30:00+01:00,3,2,1,0,11060.52,-1
2022-10-17 19:30:00+01:00,6,1,5,0,11068.55,-5
2022-10-17 20:30:00+01:00,5,0,5,0,11060.88,-5
2022-10-18 14:30:00+01:00,0,32,0,32,11208.92,32
2022-10-18 15:30:00+01:00,0,4,0,4,11077.45,4
2022-10-18 16:30:00+01:00,0,35,0,35,11136.29,35
2022-10-18 17:30:00+01:00,0,40,0,40,11154.11,40
2022-10-18 18:30:00+01:00,0,49,0,49,11186.69,49
2022-10-18 19:30:00+01:00,0,35,0,35,11101.45,35
2022-10-18 20:30:00+01:00,0,52,0,52,11151.10,52
2022-10-19 14:30:00+01:00,7,7,0,0,11223.78,0
2022-10-19 15:30:00+01:00,7,3,4,0,11137.05,-4
2022-10-19 16:30:00+01:00,11,4,7,0,11104.38,-7
2022-10-19 17:30:00+01:00,13,4,9,0,11043.54,-9
2022-10-19 18:30:00+01:00,9,3,6,0,11094.61,-6
2022-10-19 19:30:00+01:00,10,1,9,0,11069.86,-9
2022-10-19 20:30:00+01:00,8,3,5,0,11106.16,-5
2022-10-20 14:30:00+01:00,12,5,7,0,11262.83,-7
2022-10-20 15:30:00+01:00,8,9,0,1,11218.44,1
2022-10-20 16:30:00+01:00,14,3,11,0,11146.38,-11
2022-10-20 17:30:00+01:00,25,3,22,0,11103.95,-22
2022-10-20 18:30:00+01:00,35,1,34,0,11014.18,-34
2022-10-20 19:30:00+01:00,26,3,23,0,11039.49,-23
2022-10-20 20:30:00+01:00,34,3,31,0,11044.54,-31
2022-10-21 14:30:00+01:00,29,2,27,0,11068.54,-27
2022-10-21 15:30:00+01:00,17,4,13,0,11079.16,-13
2022-10-21 16:30:00+01:00,5,7,0,2,11143.94,2
2022-10-21 17:30:00+01:00,1,12,0,11,11197.67,11
2022-10-21 18:30:00+01:00,1,11,0,10,11248.95,10
2022-10-21 19:30:00+01:00,2,22,0,20,11317.45,20
2022-10-21 20:30:00+01:00,2,18,0,16,11311.14,16
2022-10-24 14:30:00+01:00,15,11,4,0,11207.34,-4
2022-10-24 15:30:00+01:00,6,21,0,15,11327.00,15
2022-10-24 16:30:00+01:00,5,41,0,36,11384.23,36
2022-10-24 17:30:00+01:00,5,38,0,33,11349.28,33
2022-10-24 18:30:00+01:00,5,52,0,47,11386.74,47
2022-10-24 19:30:00+01:00,3,57,0,54,11457.69,54
2022-10-24 20:30:00+01:00,3,56,0,53,11429.27,53
2022-10-25 14:30:00+01:00,0,70,0,70,11601.68,70
2022-10-25 15:30:00+01:00,0,68,0,68,11629.26,68
2022-10-25 16:30:00+01:00,0,66,0,66,11644.97,66
2022-10-25 17:30:00+01:00,0,52,0,52,11598.58,52
2022-10-25 18:30:00+01:00,0,47,0,47,11639.57,47
2022-10-25 19:30:00+01:00,2,46,0,44,11668.70,44
2022-10-25 20:30:00+01:00,1,51,0,50,11668.27,50
2022-10-26 14:30:00+01:00,1,74,0,73,11532.61,73
2022-10-26 15:30:00+01:00,1,70,0,69,11636.21,69
2022-10-26 16:30:00+01:00,2,57,0,55,11595.05,55
2022-10-26 17:30:00+01:00,1,43,0,42,11444.05,42
2022-10-26 18:30:00+01:00,1,35,0,34,11437.32,34
2022-10-26 19:30:00+01:00,6,21,0,15,11421.30,15
2022-10-26 20:30:00+01:00,5,21,0,16,11401.61,16
2022-10-27 14:30:00+01:00,10,21,0,11,11382.79,11
2022-10-27 15:30:00+01:00,11,11,0,0,11293.79,0
2022-10-27 16:30:00+01:00,15,10,5,0,11212.42,-5
2022-10-27 17:30:00+01:00,13,11,2,0,11251.06,-2
2022-10-27 18:30:00+01:00,15,11,4,0,11210.52,-4
2022-10-27 19:30:00+01:00,14,9,5,0,11225.90,-5
2022-10-27 20:30:00+01:00,16,5,11,0,11191.43,-11
2022-10-28 14:30:00+01:00,17,8,9,0,11339.56,-9
2022-10-28 15:30:00+01:00,15,10,5,0,11409.33,-5
2022-10-28 16:30:00+01:00,9,10,0,1,11467.19,1
2022-10-28 17:30:00+01:00,7,17,0,10,11487.06,10
2022-10-28 18:30:00+01:00,7,20,0,13,11499.94,13
2022-10-28 19:30:00+01:00,6,28,0,22,11544.03,22
2022-10-28 20:30:00+01:00,6,27,0,21,11544.44,21
2022-10-31 13:30:00+00:00,11,10,1,0,11359.10,-1
2022-10-31 14:30:00+00:00,8,21,0,13,11420.53,13
2022-10-31 15:30:00+00:00,5,30,0,25,11437.68,25
2022-10-31 16:30:00+00:00,6,26,0,20,11449.75,20
2022-10-31 17:30:00+00:00,6,28,0,22,11428.81,22
2022-10-31 18:30:00+00:00,7,28,0,21,11411.58,21
2022-10-31 19:30:00+00:00,6,34,0,28,11406.38,28
2022-11-01 13:30:00+00:00,2,23,0,21,11394.03,21
2022-11-01 14:30:00+00:00,4,9,0,5,11334.53,5
2022-11-01 15:30:00+00:00,9,5,4,0,11304.58,-4
2022-11-01 16:30:00+00:00,13,2,11,0,11312.79,-11
2022-11-01 17:30:00+00:00,14,4,10,0,11317.50,-10
2022-11-01 18:30:00+00:00,15,4,11,0,11295.58,-11
2022-11-01 19:30:00+00:00,17,2,15,0,11287.53,-15
2022-11-02 13:30:00+00:00,21,13,8,0,11226.44,-8
2022-11-02 14:30:00+00:00,29,10,19,0,11191.64,-19
2022-11-02 15:30:00+00:00,32,10,22,0,11163.44,-22
2022-11-02 16:30:00+00:00,31,9,22,0,11177.21,-22
2022-11-02 17:30:00+00:00,6,23,0,17,11391.78,17
2022-11-02 18:30:00+00:00,26,1,25,0,10984.67,-25
2022-11-02 19:30:00+00:00,32,1,31,0,10903.48,-31
2022-11-03 13:30:00+00:00,39,0,39,0,10810.63,-39
2022-11-03 14:30:00+00:00,35,0,35,0,10748.71,-35
2022-11-03 15:30:00+00:00,29,0,29,0,10782.37,-29
2022-11-03 16:30:00+00:00,32,0,32,0,10770.56,-32
2022-11-03 17:30:00+00:00,33,0,33,0,10774.75,-33
2022-11-03 18:30:00+00:00,33,2,31,0,10762.36,-31
2022-11-03 19:30:00+00:00,33,0,33,0,10691.49,-33
2022-11-04 13:30:00+00:00,17,2,15,0,10889.98,-15
2022-11-04 14:30:00+00:00,19,2,17,0,10777.17,-17
2022-11-04 15:30:00+00:00,24,2,22,0,10746.58,-22
2022-11-04 16:30:00+00:00,26,2,24,0,10666.23,-24
2022-11-04 17:30:00+00:00,45,2,43,0,10708.80,-43
2022-11-04 18:30:00+00:00,18,11,7,0,10802.41,-7
2022-11-04 19:30:00+00:00,12,14,0,2,10856.37,2
2022-11-07 14:30:00+00:00,14,21,0,7,10854.32,7
2022-11-07 15:30:00+00:00,11,29,0,18,10902.73,18
2022-11-07 16:30:00+00:00,13,18,0,5,10860.68,5
2022-11-07 17:30:00+00:00,12,19,0,7,10885.94,7
2022-11-07 18:30:00+00:00,9,27,0,18,10959.36,18
2022-11-07 19:30:00+00:00,7,29,0,22,10988.08,22
2022-11-07 20:30:00+00:00,7,35,0,28,10977.86,28
2022-11-08 14:30:00+00:00,3,30,0,27,11052.53,27
2022-11-08 15:30:00+00:00,1,50,0,49,11152.41,49
2022-11-08 16:30:00+00:00,1,56,0,55,11159.34,55
2022-11-08 17:30:00+00:00,1,49,0,48,11066.36,48
2022-11-08 18:30:00+00:00,2,19,0,17,10912.69,17
2022-11-08 19:30:00+00:00,1,23,0,22,11075.65,22
2022-11-08 20:30:00+00:00,1,15,0,14,11060.62,14
2022-11-09 14:30:00+00:00,0,11,0,11,10960.43,11
2022-11-09 15:30:00+00:00,4,9,0,5,10951.85,5
2022-11-09 16:30:00+00:00,4,8,0,4,10924.53,4
2022-11-09 17:30:00+00:00,4,6,0,2,10883.81,2
2022-11-09 18:30:00+00:00,7,6,1,0,10867.47,-1
2022-11-09 19:30:00+00:00,9,3,6,0,10839.82,-6
2022-11-09 20:30:00+00:00,9,1,8,0,10798.99,-8
2022-11-10 14:30:00+00:00,1,13,0,12,11390.54,12
2022-11-10 15:30:00+00:00,2,7,0,5,11419.04,5
2022-11-10 16:30:00+00:00,1,9,0,8,11438.09,8
2022-11-10 17:30:00+00:00,1,21,0,20,11438.47,20
2022-11-10 18:30:00+00:00,2,50,0,48,11473.24,48
2022-11-10 19:30:00+00:00,1,45,0,44,11543.03,44
2022-11-10 20:30:00+00:00,1,49,0,48,11600.94,48
2022-11-11 14:30:00+00:00,5,67,0,62,11721.45,62
2022-11-11 15:30:00+00:00,6,58,0,52,11624.63,52
2022-11-11 16:30:00+00:00,5,61,0,56,11707.96,56
2022-11-11 17:30:00+00:00,2,63,0,61,11786.06,61
2022-11-11 18:30:00+00:00,1,63,0,62,11820.84,62
2022-11-11 19:30:00+00:00,1,65,0,64,11800.85,64
2022-11-11 20:30:00+00:00,1,67,0,66,11812.65,66
2022-11-14 14:30:00+00:00,2,37,0,35,11746.73,35
2022-11-14 15:30:00+00:00,3,31,0,28,11713.25,28
2022-11-14 16:30:00+00:00,0,36,0,36,11787.66,36
2022-11-14 17:30:00+00:00,0,43,0,43,11847.15,43
2022-11-14 18:30:00+00:00,0,38,0,38,11849.15,38
2022-11-14 19:30:00+00:00,3,22,0,19,11790.26,19
2022-11-14 20:30:00+00:00,6,7,0,1,11696.03,1
2022-11-15 14:30:00+00:00,2,16,0,14,12005.00,14
2022-11-15 15:30:00+00:00,0,24,0,24,11947.85,24
2022-11-15 16:30:00+00:00,0,17,0,17,11961.44,17
2022-11-15 17:30:00+00:00,0,7,0,7,11819.41,7
2022-11-15 18:30:00+00:00,1,7,0,6,11876.23,6
2022-11-15 19:30:00+00:00,2,8,0,6,11895.50,6
2022-11-15 20:30:00+00:00,2,6,0,4,11872.12,4
2022-11-16 14:30:00+00:00,0,1,0,1,11715.45,1
2022-11-16 15:30:00+00:00,0,3,0,3,11732.38,3
2022-11-16 16:30:00+00:00,2,2,0,0,11733.54,0
2022-11-16 17:30:00+00:00,2,2,0,0,11757.95,0
2022-11-16 18:30:00+00:00,2,2,0,0,11725.59,0
2022-11-16 19:30:00+00:00,2,2,0,0,11691.60,0
2022-11-16 20:30:00+00:00,1,4,0,3,11701.29,3
2022-11-17 14:30:00+00:00,49,0,49,0,11628.58,-49
2022-11-17 15:30:00+00:00,41,0,41,0,11606.36,-41
2022-11-17 16:30:00+00:00,45,2,43,0,11661.69,-43
2022-11-17 17:30:00+00:00,17,10,7,0,11716.55,-7
2022-11-17 18:30:00+00:00,35,4,31,0,11653.55,-31
2022-11-17 19:30:00+00:00,41,1,40,0,11605.12,-40
2022-11-17 20:30:00+00:00,29,3,26,0,11678.22,-26
2022-11-18 14:30:00+00:00,15,8,7,0,11678.64,-7
2022-11-18 15:30:00+00:00,16,11,5,0,11665.64,-5
2022-11-18 16:30:00+00:00,24,6,18,0,11604.75,-18
2022-11-18 17:30:00+00:00,22,8,14,0,11641.48,-14
2022-11-18 18:30:00+00:00,21,9,12,0,11619.38,-12
2022-11-18 19:30:00+00:00,14,11,3,0,11677.07,-3
2022-11-18 20:30:00+00:00,13,10,3,0,11679.58,-3
2022-11-21 14:30:00+00:00,14,20,0,6,11577.49,6
2022-11-21 15:30:00+00:00,14,20,0,6,11574.33,6
2022-11-21 16:30:00+00:00,18,11,7,0,11532.84,-7
2022-11-21 17:30:00+00:00,18,10,8,0,11575.47,-8
2022-11-21 18:30:00+00:00,17,13,4,0,11560.53,-4
2022-11-21 19:30:00+00:00,14,19,0,5,11554.49,5
2022-11-21 20:30:00+00:00,23,14,9,0,11553.44,-9
2022-11-22 14:30:00+00:00,20,11,9,0,11579.67,-9
2022-11-22 15:30:00+00:00,17,9,8,0,11615.08,-8
2022-11-22 16:30:00+00:00,10,19,0,9,11625.75,9
2022-11-22 17:30:00+00:00,10,18,0,8,11662.65,8
2022-11-22 18:30:00+00:00,10,23,0,13,11660.51,13
2022-11-22 19:30:00+00:00,11,25,0,14,11701.85,14
2022-11-22 20:30:00+00:00,9,24,0,15,11724.62,15
2022-11-23 14:30:00+00:00,0,46,0,46,11834.44,46
2022-11-23 15:30:00+00:00,0,46,0,46,11838.91,46
2022-11-23 16:30:00+00:00,0,42,0,42,11781.65,42
2022-11-23 17:30:00+00:00,0,31,0,31,11775.62,31
2022-11-23 18:30:00+00:00,0,46,0,46,11842.54,46
2022-11-23 19:30:00+00:00,0,51,0,51,11850.26,51
2022-11-23 20:30:00+00:00,0,47,0,47,11841.46,47
2022-11-25 14:30:00+00:00,0,29,0,29,11785.10,29
2022-11-25 15:30:00+00:00,0,28,0,28,11768.84,28
2022-11-25 16:30:00+00:00,1,28,0,27,11780.54,27
2022-11-28 14:30:00+00:00,4,14,0,10,11678.42,10
2022-11-28 15:30:00+00:00,2,9,0,7,11671.18,7
2022-11-28 16:30:00+00:00,5,9,0,4,11676.73,4
2022-11-28 17:30:00+00:00,6,8,0,2,11658.98,2
2022-11-28 18:30:00+00:00,37,3,34,0,11580.76,-34
2022-11-28 19:30:00+00:00,47,2,45,0,11559.30,-45
2022-11-28 20:30:00+00:00,31,3,28,0,11589.49,-28
2022-11-29 14:30:00+00:00,28,6,22,0,11603.51,-22
2022-11-29 15:30:00+00:00,54,2,52,0,11471.23,-52
2022-11-29 16:30:00+00:00,52,2,50,0,11496.81,-50
2022-11-29 17:30:00+00:00,51,2,49,0,11463.81,-49
2022-11-29 18:30:00+00:00,40,4,36,0,11492.84,-36
2022-11-29 19:30:00+00:00,37,4,33,0,11494.80,-33
2022-11-29 20:30:00+00:00,37,4,33,0,11504.93,-33
2022-11-30 14:30:00+00:00,21,5,16,0,11534.08,-16
2022-11-30 15:30:00+00:00,18,5,13,0,11530.88,-13
2022-11-30 16:30:00+00:00,23,4,19,0,11499.04,-19
2022-11-30 17:30:00+00:00,12,4,8,0,11539.53,-8
2022-11-30 18:30:00+00:00,1,33,0,32,11890.17,32
2022-11-30 19:30:00+00:00,1,43,0,42,11950.23,42
2022-11-30 20:30:00+00:00,2,45,0,43,12026.41,43
2022-12-01 14:30:00+00:00,3,37,0,34,11947.18,34
2022-12-01 15:30:00+00:00,0,62,0,62,12009.34,62
2022-12-01 16:30:00+00:00,2,61,0,59,12017.46,59
2022-12-01 17:30:00+00:00,1,60,0,59,12015.84,59
2022-12-01 18:30:00+00:00,2,60,0,58,12042.92,58
2022-12-01 19:30:00+00:00,1,62,0,61,12043.39,61
2022-12-01 20:30:00+00:00,0,64,0,64,12042.70,64
2022-12-02 14:30:00+00:00,1,31,0,30,11890.21,30
2022-12-02 15:30:00+00:00,1,37,0,36,11912.17,36
2022-12-02 16:30:00+00:00,0,43,0,43,11925.68,43
2022-12-02 17:30:00+00:00,1,41,0,40,11910.44,40
2022-12-02 18:30:00+00:00,3,18,0,15,11919.92,15
2022-12-02 19:30:00+00:00,2,17,0,15,11992.98,15
2022-12-02 20:30:00+00:00,5,10,0,5,11994.81,5
2022-12-05 14:30:00+00:00,13,7,6,0,11872.26,-6
2022-12-05 15:30:00+00:00,18,9,9,0,11873.30,-9
2022-12-05 16:30:00+00:00,22,7,15,0,11844.68,-15
2022-12-05 17:30:00+00:00,25,6,19,0,11813.73,-19
2022-12-05 18:30:00+00:00,36,3,33,0,11761.71,-33
2022-12-05 19:30:00+00:00,43,4,39,0,11743.71,-39
2022-12-05 20:30:00+00:00,29,4,25,0,11788.92,-25
2022-12-06 14:30:00+00:00,36,2,34,0,11616.28,-34
2022-12-06 15:30:00+00:00,44,2,42,0,11618.72,-42
2022-12-06 16:30:00+00:00,54,2,52,0,11586.93,-52
2022-12-06 17:30:00+00:00,60,1,59,0,11546.68,-59
2022-12-06 18:30:00+00:00,63,2,61,0,11504.38,-61
2022-12-06 19:30:00+00:00,78,1,77,0,11495.97,-77
2022-12-06 20:30:00+00:00,62,2,60,0,11551.00,-60
2022-12-07 14:30:00+00:00,41,4,37,0,11502.56,-37
2022-12-07 15:30:00+00:00,53,2,51,0,11458.72,-51
2022-12-07 16:30:00+00:00,44,2,42,0,11471.53,-42
2022-12-07 17:30:00+00:00,28,2,26,0,11531.94,-26
2022-12-07 18:30:00+00:00,24,3,21,0,11498.39,-21
2022-12-07 19:30:00+00:00,20,0,20,0,11482.13,-20
2022-12-07 20:30:00+00:00,28,0,28,0,11496.13,-28
2022-12-08 14:30:00+00:00,4,10,0,6,11637.54,6
2022-12-08 15:30:00+00:00,6,8,0,2,11612.18,2
2022-12-08 16:30:00+00:00,7,11,0,4,11597.63,4
2022-12-08 17:30:00+00:00,5,22,0,17,11640.75,17
2022-12-08 18:30:00+00:00,5,20,0,15,11598.73,15
2022-12-08 19:30:00+00:00,3,24,0,21,11648.93,21
2022-12-08 20:30:00+00:00,5,21,0,16,11636.72,16
2022-12-09 14:30:00+00:00,6,25,0,19,11620.36,19
2022-12-09 15:30:00+00:00,4,31,0,27,11679.68,27
2022-12-09 16:30:00+00:00,4,32,0,28,11683.80,28
2022-12-09 17:30:00+00:00,9,21,0,12,11643.06,12
2022-12-09 18:30:00+00:00,8,24,0,16,11655.16,16
2022-12-09 19:30:00+00:00,8,25,0,17,11638.30,17
2022-12-09 20:30:00+00:00,10,10,0,0,11563.51,0
2022-12-12 14:30:00+00:00,24,4,20,0,11569.81,-20
2022-12-12 15:30:00+00:00,19,8,11,0,11576.23,-11
2022-12-12 16:30:00+00:00,14,9,5,0,11578.63,-5
2022-12-12 17:30:00+00:00,17,8,9,0,11581.84,-9
2022-12-12 18:30:00+00:00,12,6,6,0,11595.11,-6
2022-12-12 19:30:00+00:00,9,11,0,2,11673.86,2
2022-12-12 20:30:00+00:00,7,8,0,1,11705.53,1
2022-12-13 14:30:00+00:00,4,45,0,41,11985.35,41
2022-12-13 15:30:00+00:00,4,35,0,31,11964.86,31
2022-12-13 16:30:00+00:00,4,5,0,1,11763.84,1
2022-12-13 17:30:00+00:00,4,8,0,4,11825.76,4
2022-12-13 18:30:00+00:00,5,9,0,4,11823.53,4
2022-12-13 19:30:00+00:00,3,13,0,10,11824.94,10
2022-12-13 20:30:00+00:00,3,26,0,23,11832.01,23
2022-12-14 14:30:00+00:00,2,40,0,38,11907.26,38
2022-12-14 15:30:00+00:00,3,37,0,34,11921.43,34
2022-12-14 16:30:00+00:00,3,14,0,11,11880.73,11
2022-12-14 17:30:00+00:00,2,17,0,15,11887.59,15
2022-12-14 18:30:00+00:00,3,7,0,4,11755.33,4
2022-12-14 19:30:00+00:00,10,6,4,0,11720.08,-4
2022-12-14 20:30:00+00:00,9,5,4,0,11740.60,-4
2022-12-15 14:30:00+00:00,52,0,52,0,11439.72,-52
2022-12-15 15:30:00+00:00,52,1,51,0,11385.37,-51
2022-12-15 16:30:00+00:00,39,1,38,0,11374.65,-38
2022-12-15 17:30:00+00:00,61,1,60,0,11322.92,-60
2022-12-15 18:30:00+00:00,60,0,60,0,11316.06,-60
2022-12-15 19:30:00+00:00,50,0,50,0,11382.02,-50
2022-12-15 20:30:00+00:00,53,0,53,0,11352.18,-53
2022-12-16 14:30:00+00:00,72,0,72,0,11240.00,-72
2022-12-16 15:30:00+00:00,73,0,73,0,11213.33,-73
2022-12-16 16:30:00+00:00,76,1,75,0,11216.44,-75
2022-12-16 17:30:00+00:00,79,0,79,0,11184.93,-79
2022-12-16 18:30:00+00:00,75,0,75,0,11195.43,-75
2022-12-16 19:30:00+00:00,55,0,55,0,11262.55,-55
2022-12-16 20:30:00+00:00,59,2,57,0,11237.67,-57
2022-12-19 14:30:00+00:00,26,2,24,0,11194.47,-24
2022-12-19 15:30:00+00:00,29,1,28,0,11122.70,-28
2022-12-19 16:30:00+00:00,33,3,30,0,11107.05,-30
2022-12-19 17:30:00+00:00,25,1,24,0,11127.99,-24
2022-12-19 18:30:00+00:00,30,1,29,0,11054.42,-29
2022-12-19 19:30:00+00:00,41,1,40,0,11045.76,-40
2022-12-19 20:30:00+00:00,26,1,25,0,11087.71,-25
2022-12-20 14:30:00+00:00,7,5,2,0,11106.67,-2
2022-12-20 15:30:00+00:00,16,1,15,0,11012.35,-15
2022-12-20 16:30:00+00:00,7,0,7,0,11082.54,-7
2022-12-20 17:30:00+00:00,5,5,0,0,11094.95,0
2022-12-20 18:30:00+00:00,6,1,5,0,11090.41,-5
2022-12-20 19:30:00+00:00,15,0,15,0,11088.20,-15
2022-12-20 20:30:00+00:00,12,0,12,0,11072.22,-12
2022-12-21 14:30:00+00:00,6,6,0,0,11189.52,0
2022-12-21 15:30:00+00:00,3,10,0,7,11241.76,7
2022-12-21 16:30:00+00:00,3,10,0,7,11214.58,7
2022-12-21 17:30:00+00:00,3,11,0,8,11228.88,8
2022-12-21 18:30:00+00:00,1,32,0,31,11259.07,31
2022-12-21 19:30:00+00:00,3,20,0,17,11224.24,17
2022-12-21 20:30:00+00:00,3,18,0,15,11234.54,15
2022-12-22 14:30:00+00:00,11,4,7,0,10936.48,-7
2022-12-22 15:30:00+00:00,5,4,1,0,10913.54,-1
2022-12-22 16:30:00+00:00,22,4,18,0,10833.95,-18
2022-12-22 17:30:00+00:00,24,5,19,0,10801.76,-19
2022-12-22 18:30:00+00:00,12,3,9,0,10862.00,-9
2022-12-22 19:30:00+00:00,5,4,1,0,10948.56,-1
2022-12-22 20:30:00+00:00,4,3,1,0,10958.01,-1
2022-12-23 14:30:00+00:00,11,2,9,0,10943.41,-9
2022-12-23 15:30:00+00:00,27,2,25,0,10924.58,-25
2022-12-23 16:30:00+00:00,14,2,12,0,10967.63,-12
2022-12-23 17:30:00+00:00,20,3,17,0,10957.14,-17
2022-12-23 18:30:00+00:00,23,2,21,0,10954.67,-21
2022-12-23 19:30:00+00:00,19,3,16,0,10962.84,-16
2022-12-23 20:30:00+00:00,17,1,16,0,10983.07,-16
2022-12-27 14:30:00+00:00,6,10,0,4,10893.20,4
2022-12-27 15:30:00+00:00,7,10,0,3,10887.12,3
2022-12-27 16:30:00+00:00,3,20,0,17,10867.07,17
2022-12-27 17:30:00+00:00,2,27,0,25,10852.52,25
2022-12-27 18:30:00+00:00,9,16,0,7,10819.85,7
2022-12-27 19:30:00+00:00,18,14,4,0,10848.92,-4
2022-12-27 20:30:00+00:00,17,10,7,0,10823.28,-7
2022-12-28 14:30:00+00:00,14,3,11,0,10808.75,-11
2022-12-28 15:30:00+00:00,15,4,11,0,10737.04,-11
2022-12-28 16:30:00+00:00,31,1,30,0,10706.18,-30
2022-12-28 17:30:00+00:00,15,2,13,0,10756.26,-13
2022-12-28 18:30:00+00:00,24,2,22,0,10719.38,-22
2022-12-28 19:30:00+00:00,25,2,23,0,10684.17,-23
2022-12-28 20:30:00+00:00,37,2,35,0,10680.95,-35
2022-12-29 14:30:00+00:00,3,2,1,0,10904.99,-1
2022-12-29 15:30:00+00:00,2,4,0,2,10937.53,2
2022-12-29 16:30:00+00:00,0,8,0,8,10956.58,8
2022-12-29 17:30:00+00:00,2,11,0,9,10943.96,9
2022-12-29 18:30:00+00:00,1,14,0,13,10950.29,13
2022-12-29 19:30:00+00:00,3,11,0,8,10960.84,8
2022-12-29 20:30:00+00:00,1,14,0,13,10947.69,13
2022-12-30 14:30:00+00:00,4,10,0,6,10841.62,6
2022-12-30 15:30:00+00:00,4,14,0,10,10827.82,10
2022-12-30 16:30:00+00:00,0,15,0,15,10860.17,15
2022-12-30 17:30:00+00:00,4,4,0,0,10817.60,0
2022-12-30 18:30:00+00:00,6,14,0,8,10819.25,8
2022-12-30 19:30:00+00:00,1,23,0,22,10859.86,22
2022-12-30 20:30:00+00:00,0,35,0,35,10941.18,35
2023-01-03 14:30:00+00:00,5,12,0,7,10861.51,7
2023-01-03 15:30:00+00:00,10,8,2,0,10834.07,-2
2023-01-03 16:30:00+00:00,22,3,19,0,10794.88,-19
2023-01-03 17:30:00+00:00,13,4,9,0,10820.93,-9
2023-01-03 18:30:00+00:00,12,4,8,0,10824.70,-8
2023-01-03 19:30:00+00:00,5,3,2,0,10863.41,-2
2023-01-03 20:30:00+00:00,5,2,3,0,10864.36,-3
2023-01-04 14:30:00+00:00,4,21,0,17,10826.41,17
2023-01-04 15:30:00+00:00,2,30,0,28,10909.71,28
2023-01-04 16:30:00+00:00,1,34,0,33,10956.91,33
2023-01-04 17:30:00+00:00,1,40,0,39,10941.53,39
2023-01-04 18:30:00+00:00,1,22,0,21,10832.48,21
2023-01-04 19:30:00+00:00,2,18,0,16,10877.75,16
2023-01-04 20:30:00+00:00,6,18,0,12,10919.04,12
2023-01-05 14:30:00+00:00,7,13,0,6,10800.07,6
2023-01-05 15:30:00+00:00,6,15,0,9,10770.68,9
2023-01-05 16:30:00+00:00,8,18,0,10,10779.30,10
2023-01-05 17:30:00+00:00,8,20,0,12,10807.74,12
2023-01-05 18:30:00+00:00,7,17,0,10,10784.04,10
2023-01-05 19:30:00+00:00,14,14,0,0,10760.36,0
2023-01-05 20:30:00+00:00,15,16,0,1,10742.07,1
2023-01-06 14:30:00+00:00,9,11,0,2,10815.22,2
2023-01-06 15:30:00+00:00,8,11,0,3,10907.68,3
2023-01-06 16:30:00+00:00,11,12,0,1,10942.14,1
2023-01-06 17:30:00+00:00,7,14,0,7,10962.87,7
2023-01-06 18:30:00+00:00,5,33,0,28,11026.96,28
2023-01-06 19:30:00+00:00,5,30,0,25,11054.26,25
2023-01-06 20:30:00+00:00,5,24,0,19,11036.25,19
2023-01-09 14:30:00+00:00,4,55,0,51,11224.54,51
2023-01-09 15:30:00+00:00,2,63,0,61,11294.88,61
2023-01-09 16:30:00+00:00,3,64,0,61,11289.51,61
2023-01-09 17:30:00+00:00,2,59,0,57,11280.84,57
2023-01-09 18:30:00+00:00,2,56,0,54,11221.40,54
2023-01-09 19:30:00+00:00,3,48,0,45,11138.17,45
2023-01-09 20:30:00+00:00,5,47,0,42,11108.15,42
2023-01-10 14:30:00+00:00,3,31,0,28,11132.09,28
2023-01-10 15:30:00+00:00,3,18,0,15,11118.39,15
2023-01-10 16:30:00+00:00,3,21,0,18,11117.27,18
2023-01-10 17:30:00+00:00,3,17,0,14,11149.90,14
2023-01-10 18:30:00+00:00,3,17,0,14,11186.57,14
2023-01-10 19:30:00+00:00,5,12,0,7,11165.51,7
2023-01-10 20:30:00+00:00,2,17,0,15,11204.83,15
2023-01-11 14:30:00+00:00,3,10,0,7,11310.67,7
2023-01-11 15:30:00+00:00,10,7,3,0,11294.38,-3
2023-01-11 16:30:00+00:00,8,8,0,0,11332.11,0
2023-01-11 17:30:00+00:00,8,12,0,4,11341.04,4
2023-01-11 18:30:00+00:00,5,14,0,9,11331.20,9
2023-01-11 19:30:00+00:00,2,34,0,32,11363.99,32
2023-01-11 20:30:00+00:00,2,47,0,45,11400.63,45
2023-01-12 14:30:00+00:00,3,35,0,32,11398.83,32
2023-01-12 15:30:00+00:00,4,34,0,30,11380.49,30
2023-01-12 16:30:00+00:00,1,45,0,44,11469.52,44
2023-01-12 17:30:00+00:00,2,31,0,29,11410.25,29
2023-01-12 18:30:00+00:00,4,33,0,29,11465.02,29
2023-01-12 19:30:00+00:00,3,32,0,29,11445.86,29
2023-01-12 20:30:00+00:00,3,30,0,27,11459.81,27
2023-01-13 14:30:00+00:00,3,24,0,21,11448.63,21
2023-01-13 15:30:00+00:00,3,20,0,17,11419.15,17
2023-01-13 16:30:00+00:00,3,19,0,16,11447.62,16
2023-01-13 17:30:00+00:00,3,18,0,15,11457.93,15
2023-01-13 18:30:00+00:00,4,20,0,16,11500.11,16
2023-01-13 19:30:00+00:00,8,24,0,16,11527.16,16
2023-01-13 20:30:00+00:00,4,21,0,17,11539.42,17
2023-01-17 14:30:00+00:00,1,33,0,32,11588.73,32
2023-01-17 15:30:00+00:00,2,30,0,28,11515.59,28
2023-01-17 16:30:00+00:00,10,20,0,10,11530.33,10
2023-01-17 17:30:00+00:00,3,33,0,30,11560.10,30
2023-01-17 18:30:00+00:00,11,27,0,16,11554.98,16
2023-01-17 19:30:00+00:00,7,28,0,21,11560.86,21
2023-01-17 20:30:00+00:00,7,26,0,19,11556.74,19
2023-01-18 14:30:00+00:00,10,36,0,26,11650.08,26
2023-01-18 15:30:00+00:00,15,9,6,0,11500.24,-6
2023-01-18 16:30:00+00:00,15,2,13,0,11457.35,-13
2023-01-18 17:30:00+00:00,17,6,11,0,11444.83,-11
2023-01-18 18:30:00+00:00,17,2,15,0,11474.56,-15
2023-01-18 19:30:00+00:00,20,2,18,0,11451.09,-18
2023-01-18 20:30:00+00:00,27,1,26,0,11410.37,-26
2023-01-19 14:30:00+00:00,37,0,37,0,11316.20,-37
2023-01-19 15:30:00+00:00,36,0,36,0,11271.87,-36
2023-01-19 16:30:00+00:00,34,0,34,0,11284.41,-34
2023-01-19 17:30:00+00:00,40,0,40,0,11306.36,-40
2023-01-19 18:30:00+00:00,33,0,33,0,11370.01,-33
2023-01-19 19:30:00+00:00,29,0,29,0,11355.00,-29
2023-01-19 20:30:00+00:00,38,0,38,0,11292.42,-38
2023-01-20 14:30:00+00:00,53,3,50,0,11426.33,-50
2023-01-20 15:30:00+00:00,27,7,20,0,11473.09,-20
2023-01-20 16:30:00+00:00,22,10,12,0,11478.49,-12
2023-01-20 17:30:00+00:00,22,7,15,0,11465.28,-15
2023-01-20 18:30:00+00:00,10,9,1,0,11553.49,-1
2023-01-20 19:30:00+00:00,6,10,0,4,11595.24,4
2023-01-20 20:30:00+00:00,2,15,0,13,11614.17,13
2023-01-23 14:30:00+00:00,2,52,0,50,11788.91,50
2023-01-23 15:30:00+00:00,2,68,0,66,11848.15,66
2023-01-23 16:30:00+00:00,1,64,0,63,11866.10,63
2023-01-23 17:30:00+00:00,1,65,0,64,11900.39,64
2023-01-23 18:30:00+00:00,1,57,0,56,11867.86,56
2023-01-23 19:30:00+00:00,1,58,0,57,11841.27,57
2023-01-23 20:30:00+00:00,1,70,0,69,11870.91,69
2023-01-24 14:30:00+00:00,1,50,0,49,11836.12,49
2023-01-24 15:30:00+00:00,1,52,0,51,11874.50,51
2023-01-24 16:30:00+00:00,1,51,0,50,11865.17,50
2023-01-24 17:30:00+00:00,1,55,0,54,11852.13,54
2023-01-24 18:30:00+00:00,1,46,0,45,11846.25,45
2023-01-24 19:30:00+00:00,1,43,0,42,11844.70,42
2023-01-24 20:30:00+00:00,2,40,0,38,11847.41,38
2023-01-25 14:30:00+00:00,29,3,26,0,11589.44,-26
2023-01-25 15:30:00+00:00,19,6,13,0,11664.53,-13
2023-01-25 16:30:00+00:00,18,4,14,0,11679.82,-14
2023-01-25 17:30:00+00:00,14,3,11,0,11756.35,-11
2023-01-25 18:30:00+00:00,10,6,4,0,11789.56,-4
2023-01-25 19:30:00+00:00,9,10,0,1,11808.89,1
2023-01-25 20:30:00+00:00,7,8,0,1,11813.44,1
2023-01-26 14:30:00+00:00,3,16,0,13,11967.25,13
2023-01-26 15:30:00+00:00,5,9,0,4,11887.43,4
2023-01-26 16:30:00+00:00,3,11,0,8,11943.31,8
2023-01-26 17:30:00+00:00,2,13,0,11,11942.63,11
2023-01-26 18:30:00+00:00,3,15,0,12,11987.49,12
2023-01-26 19:30:00+00:00,3,16,0,13,12024.04,13
2023-01-26 20:30:00+00:00,5,16,0,11,12053.74,11
2023-01-27 14:30:00+00:00,2,59,0,57,12110.63,57
2023-01-27 15:30:00+00:00,4,53,0,49,12101.25,49
2023-01-27 16:30:00+00:00,4,51,0,47,12155.77,47
2023-01-27 17:30:00+00:00,4,48,0,44,12170.12,44
2023-01-27 18:30:00+00:00,4,49,0,45,12208.38,45
2023-01-27 19:30:00+00:00,7,49,0,42,12234.06,42
2023-01-27 20:30:00+00:00,7,35,0,28,12166.60,28
2023-01-30 14:30:00+00:00,6,6,0,0,11993.88,0
2023-01-30 15:30:00+00:00,3,9,0,6,12000.61,6
2023-01-30 16:30:00+00:00,8,6,2,0,11994.10,-2
2023-01-30 17:30:00+00:00,9,5,4,0,11986.05,-4
2023-01-30 18:30:00+00:00,12,3,9,0,11948.24,-9
2023-01-30 19:30:00+00:00,25,0,25,0,11919.82,-25
2023-01-30 20:30:00+00:00,27,0,27,0,11912.72,-27
2023-01-31 14:30:00+00:00,15,1,14,0,12006.15,-14
2023-01-31 15:30:00+00:00,8,0,8,0,12030.67,-8
2023-01-31 16:30:00+00:00,13,0,13,0,12022.22,-13
2023-01-31 17:30:00+00:00,18,2,16,0,12021.94,-16
2023-01-31 18:30:00+00:00,18,2,16,0,12046.88,-16
2023-01-31 19:30:00+00:00,32,1,31,0,12023.45,-31
2023-01-31 20:30:00+00:00,13,7,6,0,12102.80,-6
2023-02-01 14:30:00+00:00,5,15,0,10,12090.12,10
2023-02-01 15:30:00+00:00,6,11,0,5,12079.55,5
2023-02-01 16:30:00+00:00,7,9,0,2,12066.33,2
2023-02-01 17:30:00+00:00,6,16,0,10,12085.63,10
2023-02-01 18:30:00+00:00,5,22,0,17,12100.38,17
2023-02-01 19:30:00+00:00,2,59,0,57,12377.15,57
2023-02-01 20:30:00+00:00,2,59,0,57,12363.06,57
2023-02-02 14:30:00+00:00,4,63,0,59,12683.62,59
2023-02-02 15:30:00+00:00,4,65,0,61,12759.84,61
2023-02-02 16:30:00+00:00,4,62,0,58,12763.41,58
2023-02-02 17:30:00+00:00,3,59,0,56,12802.39,56
2023-02-02 18:30:00+00:00,4,54,0,50,12765.69,50
2023-02-02 19:30:00+00:00,3,56,0,53,12730.06,53
2023-02-02 20:30:00+00:00,4,52,0,48,12797.31,48
2023-02-03 14:30:00+00:00,3,28,0,25,12738.62,25
2023-02-03 15:30:00+00:00,2,37,0,35,12792.07,35
2023-02-03 16:30:00+00:00,2,39,0,37,12780.90,37
2023-02-03 17:30:00+00:00,4,19,0,15,12645.10,15
2023-02-03 18:30:00+00:00,5,9,0,4,12602.00,4
2023-02-03 19:30:00+00:00,11,3,8,0,12580.21,-8
2023-02-03 20:30:00+00:00,12,4,8,0,12572.13,-8
2023-02-06 14:30:00+00:00,29,3,26,0,12439.36,-26
2023-02-06 15:30:00+00:00,26,3,23,0,12543.58,-23
2023-02-06 16:30:00+00:00,36,2,34,0,12486.96,-34
2023-02-06 17:30:00+00:00,43,2,41,0,12468.64,-41
2023-02-06 18:30:00+00:00,33,4,29,0,12500.08,-29
2023-02-06 19:30:00+00:00,38,2,36,0,12440.08,-36
2023-02-06 20:30:00+00:00,46,1,45,0,12465.74,-45
2023-02-07 14:30:00+00:00,37,0,37,0,12452.37,-37
2023-02-07 15:30:00+00:00,43,0,43,0,12514.35,-43
2023-02-07 16:30:00+00:00,39,1,38,0,12498.12,-38
2023-02-07 17:30:00+00:00,24,2,22,0,12505.17,-22
2023-02-07 18:30:00+00:00,7,4,3,0,12588.13,-3
2023-02-07 19:30:00+00:00,2,9,0,7,12702.17,7
2023-02-07 20:30:00+00:00,1,10,0,9,12728.45,9
2023-02-08 14:30:00+00:00,1,11,0,10,12624.52,10
2023-02-08 15:30:00+00:00,8,4,4,0,12492.46,-4
2023-02-08 16:30:00+00:00,4,8,0,4,12543.70,4
2023-02-08 17:30:00+00:00,4,5,0,1,12531.45,1
2023-02-08 18:30:00+00:00,5,6,0,1,12522.90,1
2023-02-08 19:30:00+00:00,5,7,0,2,12488.56,2
2023-02-08 20:30:00+00:00,8,8,0,0,12498.19,0
2023-02-09 14:30:00+00:00,3,21,0,18,12580.67,18
2023-02-09 15:30:00+00:00,6,12,0,6,12540.44,6
2023-02-09 16:30:00+00:00,7,15,0,8,12543.72,8
2023-02-09 17:30:00+00:00,7,11,0,4,12495.10,4
2023-02-09 18:30:00+00:00,20,4,16,0,12422.08,-16
2023-02-09 19:30:00+00:00,44,1,43,0,12363.70,-43
2023-02-09 20:30:00+00:00,41,1,40,0,12383.28,-40
2023-02-10 14:30:00+00:00,28,3,25,0,12339.28,-25
2023-02-10 15:30:00+00:00,24,5,19,0,12287.68,-19
2023-02-10 16:30:00+00:00,37,5,32,0,12223.04,-32
2023-02-10 17:30:00+00:00,20,4,16,0,12301.04,-16
2023-02-10 18:30:00+00:00,24,4,20,0,12249.12,-20
2023-02-10 19:30:00+00:00,19,4,15,0,12268.05,-15
2023-02-10 20:30:00+00:00,15,6,9,0,12305.60,-9
2023-02-13 14:30:00+00:00,18,4,14,0,12418.74,-14
2023-02-13 15:30:00+00:00,11,12,0,1,12480.79,1
2023-02-13 16:30:00+00:00,10,12,0,2,12497.76,2
2023-02-13 17:30:00+00:00,5,18,0,13,12510.07,13
2023-02-13 18:30:00+00:00,5,23,0,18,12480.51,18
2023-02-13 19:30:00+00:00,4,24,0,20,12483.29,20
2023-02-13 20:30:00+00:00,4,28,0,24,12500.89,24
2023-02-14 14:30:00+00:00,4,28,0,24,12553.33,24
2023-02-14 15:30:00+00:00,4,15,0,11,12432.87,11
2023-02-14 16:30:00+00:00,2,24,0,22,12459.71,22
2023-02-14 17:30:00+00:00,1,25,0,24,12542.61,24
2023-02-14 18:30:00+00:00,2,39,0,37,12550.98,37
2023-02-14 19:30:00+00:00,1,41,0,40,12588.53,40
2023-02-14 20:30:00+00:00,2,37,0,35,12589.07,35
2023-02-15 14:30:00+00:00,6,21,0,15,12538.08,15
2023-02-15 15:30:00+00:00,7,22,0,15,12588.50,15
2023-02-15 16:30:00+00:00,8,18,0,10,12574.25,10
2023-02-15 17:30:00+00:00,8,23,0,15,12615.13,15
2023-02-15 18:30:00+00:00,6,27,0,21,12661.45,21
2023-02-15 19:30:00+00:00,4,24,0,20,12633.95,20
2023-02-15 20:30:00+00:00,1,25,0,24,12688.44,24
2023-02-16 14:30:00+00:00,7,10,0,3,12577.85,3
2023-02-16 15:30:00+00:00,2,26,0,24,12604.37,24
2023-02-16 16:30:00+00:00,5,22,0,17,12614.56,17
2023-02-16 17:30:00+00:00,7,16,0,9,12592.21,9
2023-02-16 18:30:00+00:00,6,17,0,11,12616.26,11
2023-02-16 19:30:00+00:00,12,5,7,0,12479.11,-7
2023-02-16 20:30:00+00:00,16,5,11,0,12440.19,-11
2023-02-17 14:30:00+00:00,20,5,15,0,12318.58,-15
2023-02-17 15:30:00+00:00,35,1,34,0,12258.94,-34
2023-02-17 16:30:00+00:00,32,2,30,0,12278.16,-30
2023-02-17 17:30:00+00:00,46,1,45,0,12251.17,-45
2023-02-17 18:30:00+00:00,45,1,44,0,12308.32,-44
2023-02-17 19:30:00+00:00,40,1,39,0,12326.49,-39
2023-02-17 20:30:00+00:00,45,1,44,0,12357.82,-44
2023-02-21 14:30:00+00:00,55,3,52,0,12154.50,-52
2023-02-21 15:30:00+00:00,60,2,58,0,12127.99,-58
2023-02-21 16:30:00+00:00,62,2,60,0,12112.40,-60
2023-02-21 17:30:00+00:00,60,0,60,0,12113.70,-60
2023-02-21 18:30:00+00:00,66,1,65,0,12088.01,-65
2023-02-21 19:30:00+00:00,57,2,55,0,12076.15,-55
2023-02-21 20:30:00+00:00,55,3,52,0,12059.09,-52
2023-02-22 14:30:00+00:00,45,2,43,0,12034.13,-43
2023-02-22 15:30:00+00:00,32,2,30,0,12060.11,-30
2023-02-22 16:30:00+00:00,33,4,29,0,12088.66,-29
2023-02-22 17:30:00+00:00,23,5,18,0,12133.97,-18
2023-02-22 18:30:00+00:00,36,3,33,0,12088.52,-33
2023-02-22 19:30:00+00:00,49,3,46,0,12044.48,-46
2023-02-22 20:30:00+00:00,49,2,47,0,12068.23,-47
2023-02-23 14:30:00+00:00,23,9,14,0,12164.98,-14
2023-02-23 15:30:00+00:00,30,4,26,0,12056.02,-26
2023-02-23 16:30:00+00:00,31,6,25,0,12035.54,-25
2023-02-23 17:30:00+00:00,22,5,17,0,12055.60,-17
2023-02-23 18:30:00+00:00,12,8,4,0,12155.60,-4
2023-02-23 19:30:00+00:00,7,10,0,3,12214.70,3
2023-02-23 20:30:00+00:00,6,11,0,5,12179.42,5
2023-02-24 14:30:00+00:00,18,5,13,0,11933.06,-13
2023-02-24 15:30:00+00:00,22,4,18,0,11949.53,-18
2023-02-24 16:30:00+00:00,23,3,20,0,11947.31,-20
2023-02-24 17:30:00+00:00,28,2,26,0,11933.75,-26
2023-02-24 18:30:00+00:00,19,2,17,0,11944.56,-17
2023-02-24 19:30:00+00:00,17,2,15,0,11951.24,-15
2023-02-24 20:30:00+00:00,14,3,11,0,11971.79,-11
2023-02-27 14:30:00+00:00,5,1,4,0,12129.99,-4
2023-02-27 15:30:00+00:00,6,3,3,0,12067.36,-3
2023-02-27 16:30:00+00:00,4,4,0,0,12069.40,0
2023-02-27 17:30:00+00:00,3,4,0,1,12092.81,1
2023-02-27 18:30:00+00:00,8,2,6,0,12093.74,-6
2023-02-27 19:30:00+00:00,19,0,19,0,12063.53,-19
2023-02-27 20:30:00+00:00,15,2,13,0,12057.55,-13
2023-02-28 14:30:00+00:00,3,23,0,20,12044.77,20
2023-02-28 15:30:00+00:00,4,20,0,16,12075.21,16
2023-02-28 16:30:00+00:00,3,22,0,19,12095.60,19
2023-02-28 17:30:00+00:00,1,27,0,26,12134.90,26
2023-02-28 18:30:00+00:00,3,25,0,22,12117.70,22
2023-02-28 19:30:00+00:00,2,20,0,18,12068.72,18
2023-02-28 20:30:00+00:00,3,12,0,9,12041.20,9
2023-03-01 14:30:00+00:00,28,5,23,0,11953.14,-23
2023-03-01 15:30:00+00:00,27,7,20,0,11933.80,-20
2023-03-01 16:30:00+00:00,15,11,4,0,11990.55,-4
2023-03-01 17:30:00+00:00,24,4,20,0,11955.21,-20
2023-03-01 18:30:00+00:00,26,3,23,0,11928.35,-23
2023-03-01 19:30:00+00:00,20,4,16,0,11923.67,-16
2023-03-01 20:30:00+00:00,17,6,11,0,11940.19,-11
2023-03-02 14:30:00+00:00,17,6,11,0,11896.18,-11
2023-03-02 15:30:00+00:00,24,6,18,0,11875.26,-18
2023-03-02 16:30:00+00:00,23,8,15,0,11891.64,-15
2023-03-02 17:30:00+00:00,25,8,17,0,11897.60,-17
2023-03-02 18:30:00+00:00,5,12,0,7,12022.18,7
2023-03-02 19:30:00+00:00,3,14,0,11,12029.94,11
2023-03-02 20:30:00+00:00,3,18,0,15,12043.26,15
2023-03-03 14:30:00+00:00,0,34,0,34,12203.11,34
2023-03-03 15:30:00+00:00,1,45,0,44,12179.51,44
2023-03-03 16:30:00+00:00,1,40,0,39,12212.30,39
2023-03-03 17:30:00+00:00,0,55,0,55,12245.74,55
2023-03-03 18:30:00+00:00,0,60,0,60,12280.20,60
2023-03-03 19:30:00+00:00,0,60,0,60,12285.98,60
2023-03-03 20:30:00+00:00,0,57,0,57,12289.79,57
2023-03-06 14:30:00+00:00,1,68,0,67,12416.72,67
2023-03-06 15:30:00+00:00,1,72,0,71,12431.27,71
2023-03-06 16:30:00+00:00,1,68,0,67,12429.66,67
2023-03-06 17:30:00+00:00,1,61,0,60,12378.33,60
2023-03-06 18:30:00+00:00,5,36,0,31,12341.11,31
2023-03-06 19:30:00+00:00,5,30,0,25,12301.66,25
2023-03-06 20:30:00+00:00,5,31,0,26,12303.82,26
2023-03-07 14:30:00+00:00,8,9,0,1,12224.66,1
2023-03-07 15:30:00+00:00,10,4,6,0,12203.62,-6
2023-03-07 16:30:00+00:00,10,4,6,0,12267.62,-6
2023-03-07 17:30:00+00:00,19,4,15,0,12217.40,-15
2023-03-07 18:30:00+00:00,25,4,21,0,12158.75,-21
2023-03-07 19:30:00+00:00,32,1,31,0,12137.96,-31
2023-03-07 20:30:00+00:00,30,2,28,0,12153.31,-28
2023-03-08 14:30:00+00:00,36,1,35,0,12174.87,-35
2023-03-08 15:30:00+00:00,36,1,35,0,12186.62,-35
2023-03-08 16:30:00+00:00,43,2,41,0,12178.59,-41
2023-03-08 17:30:00+00:00,40,1,39,0,12142.61,-39
2023-03-08 18:30:00+00:00,32,2,30,0,12181.75,-30
2023-03-08 19:30:00+00:00,25,3,22,0,12156.59,-22
2023-03-08 20:30:00+00:00,16,2,14,0,12215.24,-14
2023-03-09 14:30:00+00:00,13,15,0,2,12296.79,2
2023-03-09 15:30:00+00:00,13,15,0,2,12273.87,2
2023-03-09 16:30:00+00:00,15,12,3,0,12275.20,-3
2023-03-09 17:30:00+00:00,15,5,10,0,12159.05,-10
2023-03-09 18:30:00+00:00,16,2,14,0,12088.37,-14
2023-03-09 19:30:00+00:00,24,0,24,0,11989.67,-24
2023-03-09 20:30:00+00:00,24,1,23,0,11996.90,-23
2023-03-10 14:30:00+00:00,39,2,37,0,11914.39,-37
2023-03-10 15:30:00+00:00,17,1,16,0,12036.23,-16
2023-03-10 16:30:00+00:00,31,1,30,0,11934.38,-30
2023-03-10 17:30:00+00:00,35,0,35,0,11841.31,-35
2023-03-10 18:30:00+00:00,50,1,49,0,11809.24,-49
2023-03-10 19:30:00+00:00,35,1,34,0,11859.94,-34
2023-03-10 20:30:00+00:00,53,0,53,0,11832.81,-53
2023-03-13 13:30:00+00:00,61,0,61,0,11851.77,-61
2023-03-13 14:30:00+00:00,17,3,14,0,12032.63,-14
2023-03-13 15:30:00+00:00,24,2,22,0,12002.77,-22
2023-03-13 16:30:00+00:00,20,2,18,0,11951.88,-18
2023-03-13 17:30:00+00:00,5,3,2,0,12037.84,-2
2023-03-13 18:30:00+00:00,4,3,1,0,11960.03,-1
2023-03-13 19:30:00+00:00,4,2,2,0,11921.94,-2
2023-03-14 13:30:00+00:00,0,3,0,3,12169.31,3
2023-03-14 14:30:00+00:00,1,3,0,2,12202.44,2
2023-03-14 15:30:00+00:00,0,7,0,7,12178.13,7
2023-03-14 16:30:00+00:00,0,10,0,10,12137.84,10
2023-03-14 17:30:00+00:00,0,13,0,13,12119.06,13
2023-03-14 18:30:00+00:00,0,10,0,10,12070.23,10
2023-03-14 19:30:00+00:00,0,14,0,14,12197.70,14
2023-03-15 13:30:00+00:00,1,7,0,6,12087.37,6
2023-03-15 14:30:00+00:00,9,3,6,0,12113.02,-6
2023-03-15 15:30:00+00:00,7,4,3,0,12090.78,-3
2023-03-15 16:30:00+00:00,4,9,0,5,12151.95,5
2023-03-15 17:30:00+00:00,5,10,0,5,12221.49,5
2023-03-15 18:30:00+00:00,2,18,0,16,12250.29,16
2023-03-15 19:30:00+00:00,3,19,0,16,12252.46,16
2023-03-16 13:30:00+00:00,9,11,0,2,12276.73,2
2023-03-16 14:30:00+00:00,2,16,0,14,12460.99,14
2023-03-16 15:30:00+00:00,2,13,0,11,12502.37,11
2023-03-16 16:30:00+00:00,1,17,0,16,12529.98,16
2023-03-16 17:30:00+00:00,0,20,0,20,12532.37,20
2023-03-16 18:30:00+00:00,0,34,0,34,12592.33,34
2023-03-16 19:30:00+00:00,0,20,0,20,12579.87,20
2023-03-17 13:30:00+00:00,1,37,0,36,12556.08,36
2023-03-17 14:30:00+00:00,2,28,0,26,12476.59,26
2023-03-17 15:30:00+00:00,0,35,0,35,12513.75,35
2023-03-17 16:30:00+00:00,3,35,0,32,12538.38,32
2023-03-17 17:30:00+00:00,3,21,0,18,12483.15,18
2023-03-17 18:30:00+00:00,4,22,0,18,12533.29,18
2023-03-17 19:30:00+00:00,3,22,0,19,12519.60,19
2023-03-20 13:30:00+00:00,1,20,0,19,12480.91,19
2023-03-20 14:30:00+00:00,4,8,0,4,12562.90,4
2023-03-20 15:30:00+00:00,7,4,3,0,12475.44,-3
2023-03-20 16:30:00+00:00,7,5,2,0,12524.50,-2
2023-03-20 17:30:00+00:00,3,4,0,1,12537.69,1
2023-03-20 18:30:00+00:00,5,4,1,0,12532.95,-1
2023-03-20 19:30:00+00:00,4,5,0,1,12561.21,1
2023-03-21 13:30:00+00:00,4,18,0,14,12619.12,14
2023-03-21 14:30:00+00:00,2,28,0,26,12625.10,26
2023-03-21 15:30:00+00:00,2,19,0,17,12636.64,17
2023-03-21 16:30:00+00:00,3,20,0,17,12672.45,17
2023-03-21 17:30:00+00:00,2,33,0,31,12676.19,31
2023-03-21 18:30:00+00:00,1,34,0,33,12727.19,33
2023-03-21 19:30:00+00:00,3,38,0,35,12738.55,35
2023-03-22 13:30:00+00:00,3,31,0,28,12801.15,28
2023-03-22 14:30:00+00:00,3,20,0,17,12786.88,17
2023-03-22 15:30:00+00:00,3,32,0,29,12752.22,29
2023-03-22 16:30:00+00:00,6,25,0,19,12773.43,19
2023-03-22 17:30:00+00:00,5,33,0,28,12852.59,28
2023-03-22 18:30:00+00:00,6,28,0,22,12819.11,22
2023-03-22 19:30:00+00:00,16,0,16,0,12566.28,-16
2023-03-23 13:30:00+00:00,9,4,5,0,12807.94,-5
2023-03-23 14:30:00+00:00,2,7,0,5,12845.41,5
2023-03-23 15:30:00+00:00,4,7,0,3,12855.98,3
2023-03-23 16:30:00+00:00,5,3,2,0,12791.83,-2
2023-03-23 17:30:00+00:00,11,2,9,0,12688.42,-9
2023-03-23 18:30:00+00:00,16,1,15,0,12671.24,-15
2023-03-23 19:30:00+00:00,16,3,13,0,12729.93,-13
2023-03-24 13:30:00+00:00,9,3,6,0,12698.07,-6
2023-03-24 14:30:00+00:00,12,2,10,0,12628.55,-10
2023-03-24 15:30:00+00:00,7,5,2,0,12651.39,-2
2023-03-24 16:30:00+00:00,4,4,0,0,12692.24,0
2023-03-24 17:30:00+00:00,10,4,6,0,12707.88,-6
2023-03-24 18:30:00+00:00,4,5,0,1,12758.00,1
2023-03-24 19:30:00+00:00,1,20,0,19,12768.31,19
2023-03-27 14:30:00+01:00,9,13,0,4,12775.26,4
2023-03-27 15:30:00+01:00,19,6,13,0,12726.00,-13
2023-03-27 16:30:00+01:00,17,5,12,0,12693.56,-12
2023-03-27 17:30:00+01:00,11,15,0,4,12682.30,4
2023-03-27 18:30:00+01:00,6,23,0,17,12710.50,17
2023-03-27 19:30:00+01:00,6,30,0,24,12719.68,24
2023-03-27 20:30:00+01:00,15,20,0,5,12673.24,5
2023-03-28 14:30:00+01:00,19,22,0,3,12582.41,3
2023-03-28 15:30:00+01:00,9,35,0,26,12589.74,26
2023-03-28 16:30:00+01:00,14,19,0,5,12559.96,5
2023-03-28 17:30:00+01:00,13,15,0,2,12566.87,2
2023-03-28 18:30:00+01:00,17,6,11,0,12548.79,-11
2023-03-28 19:30:00+01:00,22,5,17,0,12568.62,-17
2023-03-28 20:30:00+01:00,16,9,7,0,12611.04,-7
2023-03-29 14:30:00+01:00,8,15,0,7,12766.78,7
2023-03-29 15:30:00+01:00,6,16,0,10,12775.63,10
2023-03-29 16:30:00+01:00,3,21,0,18,12800.96,18
2023-03-29 17:30:00+01:00,4,22,0,18,12813.09,18
2023-03-29 18:30:00+01:00,6,17,0,11,12797.73,11
2023-03-29 19:30:00+01:00,4,25,0,21,12857.90,21
2023-03-29 20:30:00+01:00,2,27,0,25,12842.92,25
2023-03-30 14:30:00+01:00,2,57,0,55,12971.94,55
2023-03-30 15:30:00+01:00,2,51,0,49,12958.45,49
2023-03-30 16:30:00+01:00,2,51,0,49,12944.39,49
2023-03-30 17:30:00+01:00,4,47,0,43,12927.91,43
2023-03-30 18:30:00+01:00,3,57,0,54,12942.80,54
2023-03-30 19:30:00+01:00,3,62,0,59,12962.11,59
2023-03-30 20:30:00+01:00,5,55,0,50,12960.50,50
2023-03-31 14:30:00+01:00,2,48,0,46,13029.00,46
2023-03-31 15:30:00+01:00,2,57,0,55,13065.48,55
2023-03-31 16:30:00+01:00,2,57,0,55,13113.30,55
2023-03-31 17:30:00+01:00,2,46,0,44,13101.35,44
2023-03-31 18:30:00+01:00,2,44,0,42,13110.32,42
2023-03-31 19:30:00+01:00,2,53,0,51,13175.10,51
2023-03-31 20:30:00+01:00,3,51,0,48,13176.60,48
2023-04-03 14:30:00+01:00,5,24,0,19,13140.61,19
2023-04-03 15:30:00+01:00,5,19,0,14,13066.83,14
2023-04-03 16:30:00+01:00,6,31,0,25,13072.20,25
2023-04-03 17:30:00+01:00,5,29,0,24,13043.13,24
2023-04-03 18:30:00+01:00,4,25,0,21,13064.55,21
2023-04-03 19:30:00+01:00,4,24,0,20,13124.78,20
2023-04-03 20:30:00+01:00,4,24,0,20,13146.67,20
2023-04-04 14:30:00+01:00,5,15,0,10,13153.46,10
2023-04-04 15:30:00+01:00,11,12,0,1,13117.33,1
2023-04-04 16:30:00+01:00,24,6,18,0,13096.97,-18
2023-04-04 17:30:00+01:00,16,8,8,0,13117.16,-8
2023-04-04 18:30:00+01:00,19,5,14,0,13080.24,-14
2023-04-04 19:30:00+01:00,33,4,29,0,13066.04,-29
2023-04-04 20:30:00+01:00,26,5,21,0,13100.86,-21
2023-04-05 14:30:00+01:00,34,8,26,0,12978.34,-26
2023-04-05 15:30:00+01:00,36,9,27,0,12925.47,-27
2023-04-05 16:30:00+01:00,35,7,28,0,12903.25,-28
2023-04-05 17:30:00+01:00,31,9,22,0,12926.93,-22
2023-04-05 18:30:00+01:00,28,9,19,0,12941.37,-19
2023-04-05 19:30:00+01:00,36,8,28,0,12941.69,-28
2023-04-05 20:30:00+01:00,39,8,31,0,12966.76,-31
2023-04-06 14:30:00+01:00,47,8,39,0,12918.75,-39
2023-04-06 15:30:00+01:00,36,10,26,0,12962.88,-26
2023-04-06 16:30:00+01:00,21,14,7,0,13028.09,-7
2023-04-06 17:30:00+01:00,25,14,11,0,13037.36,-11
2023-04-06 18:30:00+01:00,18,14,4,0,13071.36,-4
2023-04-06 19:30:00+01:00,17,14,3,0,13061.71,-3
2023-04-06 20:30:00+01:00,24,12,12,0,13060.96,-12
2023-04-10 14:30:00+01:00,16,3,13,0,12886.56,-13
2023-04-10 15:30:00+01:00,4,10,0,6,12955.70,6
2023-04-10 16:30:00+01:00,7,9,0,2,12937.36,2
2023-04-10 17:30:00+01:00,2,13,0,11,13023.16,11
2023-04-10 18:30:00+01:00,3,14,0,11,13030.01,11
2023-04-10 19:30:00+01:00,2,12,0,10,13027.27,10
2023-04-10 20:30:00+01:00,1,11,0,10,13046.64,10
2023-04-11 14:30:00+01:00,2,20,0,18,12996.75,18
2023-04-11 15:30:00+01:00,3,18,0,15,12967.42,15
2023-04-11 16:30:00+01:00,7,17,0,10,12977.32,10
2023-04-11 17:30:00+01:00,5,16,0,11,12991.95,11
2023-04-11 18:30:00+01:00,1,16,0,15,13016.24,15
2023-04-11 19:30:00+01:00,3,20,0,17,13013.52,17
2023-04-11 20:30:00+01:00,4,14,0,10,12964.92,10
2023-04-12 14:30:00+01:00,2,39,0,37,13011.02,37
2023-04-12 15:30:00+01:00,4,17,0,13,12919.53,13
2023-04-12 16:30:00+01:00,3,18,0,15,12971.89,15
2023-04-12 17:30:00+01:00,5,13,0,8,12984.29,8
2023-04-12 18:30:00+01:00,8,9,0,1,12913.52,1
2023-04-12 19:30:00+01:00,16,5,11,0,12845.78,-11
2023-04-12 20:30:00+01:00,16,3,13,0,12848.96,-13
2023-04-13 14:30:00+01:00,13,6,7,0,13028.05,-7
2023-04-13 15:30:00+01:00,12,9,3,0,13026.33,-3
2023-04-13 16:30:00+01:00,7,4,3,0,13052.95,-3
2023-04-13 17:30:00+01:00,4,3,1,0,13060.56,-1
2023-04-13 18:30:00+01:00,4,6,0,2,13100.99,2
2023-04-13 19:30:00+01:00,5,6,0,1,13116.47,1
2023-04-13 20:30:00+01:00,4,8,0,4,13108.26,4
2023-04-14 14:30:00+01:00,5,2,3,0,13043.67,-3
2023-04-14 15:30:00+01:00,4,10,0,6,13036.99,6
2023-04-14 16:30:00+01:00,8,6,2,0,13008.91,-2
2023-04-14 17:30:00+01:00,9,3,6,0,12986.43,-6
2023-04-14 18:30:00+01:00,1,10,0,9,13053.13,9
2023-04-14 19:30:00+01:00,2,23,0,21,13057.92,21
2023-04-14 20:30:00+01:00,1,26,0,25,13080.94,25
2023-04-17 14:30:00+01:00,6,18,0,12,13055.51,12
2023-04-17 15:30:00+01:00,8,12,0,4,13021.96,4
2023-04-17 16:30:00+01:00,12,9,3,0,12995.91,-3
2023-04-17 17:30:00+01:00,10,9,1,0,13021.15,-1
2023-04-17 18:30:00+01:00,11,7,4,0,13008.22,-4
2023-04-17 19:30:00+01:00,11,9,2,0,13075.08,-2
2023-04-17 20:30:00+01:00,8,9,0,1,13086.82,1
2023-04-18 14:30:00+01:00,5,17,0,12,13079.94,12
2023-04-18 15:30:00+01:00,6,22,0,16,13087.85,16
2023-04-18 16:30:00+01:00,5,25,0,20,13100.67,20
2023-04-18 17:30:00+01:00,7,26,0,19,13073.85,19
2023-04-18 18:30:00+01:00,7,22,0,15,13090.60,15
2023-04-18 19:30:00+01:00,7,22,0,15,13076.64,15
2023-04-18 20:30:00+01:00,8,19,0,11,13093.83,11
2023-04-19 14:30:00+01:00,14,5,9,0,13020.85,-9
2023-04-19 15:30:00+01:00,11,7,4,0,13052.63,-4
2023-04-19 16:30:00+01:00,5,14,0,9,13094.48,9
2023-04-19 17:30:00+01:00,8,13,0,5,13111.60,5
2023-04-19 18:30:00+01:00,8,13,0,5,13107.88,5
2023-04-19 19:30:00+01:00,15,12,3,0,13106.78,-3
2023-04-19 20:30:00+01:00,19,10,9,0,13088.61,-9
2023-04-20 14:30:00+01:00,19,10,9,0,13042.89,-9
2023-04-20 15:30:00+01:00,20,14,6,0,13033.58,-6
2023-04-20 16:30:00+01:00,22,16,6,0,13055.88,-6
2023-04-20 17:30:00+01:00,11,26,0,15,13101.40,15
2023-04-20 18:30:00+01:00,18,10,8,0,13018.42,-8
2023-04-20 19:30:00+01:00,25,2,23,0,12936.39,-23
2023-04-20 20:30:00+01:00,17,2,15,0,12984.91,-15
2023-04-21 14:30:00+01:00,15,8,7,0,12974.22,-7
2023-04-21 15:30:00+01:00,13,6,7,0,12977.83,-7
2023-04-21 16:30:00+01:00,18,4,14,0,12980.77,-14
2023-04-21 17:30:00+01:00,24,3,21,0,12983.52,-21
2023-04-21 18:30:00+01:00,12,6,6,0,13017.44,-6
2023-04-21 19:30:00+01:00,17,6,11,0,12986.63,-11
2023-04-21 20:30:00+01:00,9,4,5,0,13001.72,-5
2023-04-24 14:30:00+01:00,6,7,0,1,13003.14,1
2023-04-24 15:30:00+01:00,13,2,11,0,12911.86,-11
2023-04-24 16:30:00+01:00,15,2,13,0,12916.24,-13
2023-04-24 17:30:00+01:00,18,1,17,0,12932.53,-17
2023-04-24 18:30:00+01:00,9,2,7,0,12963.42,-7
2023-04-24 19:30:00+01:00,6,12,0,6,12963.50,6
2023-04-24 20:30:00+01:00,7,10,0,3,12968.51,3
2023-04-25 14:30:00+01:00,24,9,15,0,12863.75,-15
2023-04-25 15:30:00+01:00,27,9,18,0,12869.83,-18
2023-04-25 16:30:00+01:00,34,8,26,0,12827.64,-26
2023-04-25 17:30:00+01:00,36,7,29,0,12800.57,-29
2023-04-25 18:30:00+01:00,45,3,42,0,12774.42,-42
2023-04-25 19:30:00+01:00,44,4,40,0,12760.92,-40
2023-04-25 20:30:00+01:00,53,4,49,0,12726.66,-49
2023-04-26 14:30:00+01:00,54,2,52,0,12838.96,-52
2023-04-26 15:30:00+01:00,39,6,33,0,12894.68,-33
2023-04-26 16:30:00+01:00,38,5,33,0,12911.33,-33
2023-04-26 17:30:00+01:00,42,5,37,0,12869.28,-37
2023-04-26 18:30:00+01:00,52,5,47,0,12841.88,-47
2023-04-26 19:30:00+01:00,55,3,52,0,12809.49,-52
2023-04-26 20:30:00+01:00,57,0,57,0,12806.90,-57
2023-04-27 14:30:00+01:00,31,8,23,0,13001.77,-23
2023-04-27 15:30:00+01:00,27,10,17,0,13061.05,-17
2023-04-27 16:30:00+01:00,21,16,5,0,13078.26,-5
2023-04-27 17:30:00+01:00,18,20,0,2,13108.70,2
2023-04-27 18:30:00+01:00,14,24,0,10,13142.67,10
2023-04-27 19:30:00+01:00,11,30,0,19,13163.93,19
2023-04-27 20:30:00+01:00,10,33,0,23,13157.57,23
2023-04-28 14:30:00+01:00,5,41,0,36,13213.81,36
2023-04-28 15:30:00+01:00,12,31,0,19,13137.92,19
2023-04-28 16:30:00+01:00,8,35,0,27,13179.11,27
2023-04-28 17:30:00+01:00,7,47,0,40,13209.43,40
2023-04-28 18:30:00+01:00,6,50,0,44,13201.05,44
2023-04-28 19:30:00+01:00,4,56,0,52,13210.81,52
2023-04-28 20:30:00+01:00,2,59,0,57,13245.65,57
2023-05-01 14:30:00+01:00,5,49,0,44,13213.74,44
2023-05-01 15:30:00+01:00,5,47,0,42,13195.75,42
2023-05-01 16:30:00+01:00,7,44,0,37,13246.24,37
2023-05-01 17:30:00+01:00,9,44,0,35,13267.38,35
2023-05-01 18:30:00+01:00,10,35,0,25,13251.00,25
2023-05-01 19:30:00+01:00,9,26,0,17,13231.96,17
2023-05-01 20:30:00+01:00,7,30,0,23,13230.33,23
2023-05-02 14:30:00+01:00,19,8,11,0,13138.15,-11
2023-05-02 15:30:00+01:00,20,8,12,0,13063.61,-12
2023-05-02 16:30:00+01:00,23,6,17,0,13083.49,-17
2023-05-02 17:30:00+01:00,25,6,19,0,13117.74,-19
2023-05-02 18:30:00+01:00,25,5,20,0,13107.34,-20
2023-05-02 19:30:00+01:00,22,8,14,0,13130.16,-14
2023-05-02 20:30:00+01:00,31,6,25,0,13111.81,-25
2023-05-03 14:30:00+01:00,19,8,11,0,13125.42,-11
2023-05-03 15:30:00+01:00,15,6,9,0,13116.93,-9
2023-05-03 16:30:00+01:00,19,5,14,0,13141.86,-14
2023-05-03 17:30:00+01:00,17,5,12,0,13157.84,-12
2023-05-03 18:30:00+01:00,11,7,4,0,13194.24,-4
2023-05-03 19:30:00+01:00,17,5,12,0,13060.18,-12
2023-05-03 20:30:00+01:00,22,5,17,0,13034.77,-17
2023-05-04 14:30:00+01:00,15,5,10,0,12947.10,-10
2023-05-04 15:30:00+01:00,8,11,0,3,13005.21,3
2023-05-04 16:30:00+01:00,7,9,0,2,13008.53,2
2023-05-04 17:30:00+01:00,9,7,2,0,13041.79,-2
2023-05-04 18:30:00+01:00,7,7,0,0,12998.52,0
2023-05-04 19:30:00+01:00,12,7,5,0,12997.42,-5
2023-05-04 20:30:00+01:00,11,4,7,0,12978.26,-7
2023-05-05 14:30:00+01:00,9,12,0,3,13167.98,3
2023-05-05 15:30:00+01:00,7,11,0,4,13205.38,4
2023-05-05 16:30:00+01:00,7,13,0,6,13182.88,6
2023-05-05 17:30:00+01:00,7,11,0,4,13220.37,4
2023-05-05 18:30:00+01:00,9,10,0,1,13254.63,1
2023-05-05 19:30:00+01:00,3,29,0,26,13274.72,26
2023-05-05 20:30:00+01:00,3,32,0,29,13256.83,29
2023-05-08 14:30:00+01:00,4,33,0,29,13211.32,29
2023-05-08 15:30:00+01:00,5,32,0,27,13227.28,27
2023-05-08 16:30:00+01:00,5,33,0,28,13253.35,28
2023-05-08 17:30:00+01:00,5,30,0,25,13276.33,25
2023-05-08 18:30:00+01:00,5,37,0,32,13276.41,32
2023-05-08 19:30:00+01:00,5,37,0,32,13280.90,32
2023-05-08 20:30:00+01:00,3,42,0,39,13288.95,39
2023-05-09 14:30:00+01:00,8,17,0,9,13221.59,9
2023-05-09 15:30:00+01:00,8,16,0,8,13214.01,8
2023-05-09 16:30:00+01:00,9,14,0,5,13201.13,5
2023-05-09 17:30:00+01:00,13,16,0,3,13219.50,3
2023-05-09 18:30:00+01:00,11,10,1,0,13223.50,-1
2023-05-09 19:30:00+01:00,23,8,15,0,13201.02,-15
2023-05-09 20:30:00+01:00,18,11,7,0,13200.45,-7
2023-05-10 14:30:00+01:00,4,18,0,14,13336.09,14
2023-05-10 15:30:00+01:00,6,17,0,11,13305.00,11
2023-05-10 16:30:00+01:00,7,12,0,5,13296.31,5
2023-05-10 17:30:00+01:00,15,7,8,0,13215.57,-8
2023-05-10 18:30:00+01:00,6,11,0,5,13288.52,5
2023-05-10 19:30:00+01:00,3,13,0,10,13369.78,10
2023-05-10 20:30:00+01:00,5,12,0,7,13346.73,7
2023-05-11 14:30:00+01:00,5,9,0,4,13346.45,4
2023-05-11 15:30:00+01:00,7,9,0,2,13376.51,2
2023-05-11 16:30:00+01:00,7,9,0,2,13383.41,2
2023-05-11 17:30:00+01:00,7,8,0,1,13374.73,1
2023-05-11 18:30:00+01:00,7,11,0,4,13379.71,4
2023-05-11 19:30:00+01:00,5,10,0,5,13399.10,5
2023-05-11 20:30:00+01:00,4,12,0,8,13387.25,8
2023-05-12 14:30:00+01:00,11,6,5,0,13350.27,-5
2023-05-12 15:30:00+01:00,10,4,6,0,13321.40,-6
2023-05-12 16:30:00+01:00,16,7,9,0,13297.32,-9
2023-05-12 17:30:00+01:00,9,10,0,1,13297.24,1
2023-05-12 18:30:00+01:00,15,5,10,0,13270.59,-10
2023-05-12 19:30:00+01:00,24,4,20,0,13301.54,-20
2023-05-12 20:30:00+01:00,11,7,4,0,13338.52,-4
2023-05-15 14:30:00+01:00,7,6,1,0,13310.47,-1
2023-05-15 15:30:00+01:00,6,17,0,11,13373.12,11
2023-05-15 16:30:00+01:00,5,19,0,14,13380.34,14
2023-05-15 17:30:00+01:00,2,28,0,26,13396.12,26
2023-05-15 18:30:00+01:00,3,25,0,22,13395.25,22
2023-05-15 19:30:00+01:00,4,24,0,20,13404.45,20
2023-05-15 20:30:00+01:00,6,26,0,20,13414.98,20
2023-05-16 14:30:00+01:00,12,24,0,12,13448.83,12
2023-05-16 15:30:00+01:00,12,34,0,22,13481.47,22
2023-05-16 16:30:00+01:00,12,30,0,18,13485.46,18
2023-05-16 17:30:00+01:00,10,28,0,18,13473.93,18
2023-05-16 18:30:00+01:00,10,33,0,23,13468.66,23
2023-05-16 19:30:00+01:00,11,29,0,18,13483.47,18
2023-05-16 20:30:00+01:00,18,16,2,0,13426.88,-2
2023-05-17 14:30:00+01:00,20,13,7,0,13458.09,-7
2023-05-17 15:30:00+01:00,20,16,4,0,13478.38,-4
2023-05-17 16:30:00+01:00,15,16,0,1,13494.83,1
2023-05-17 17:30:00+01:00,10,20,0,10,13584.09,10
2023-05-17 18:30:00+01:00,10,18,0,8,13594.06,8
2023-05-17 19:30:00+01:00,12,17,0,5,13579.71,5
2023-05-17 20:30:00+01:00,12,16,0,4,13588.32,4
2023-05-18 14:30:00+01:00,9,38,0,29,13718.98,29
2023-05-18 15:30:00+01:00,8,36,0,28,13766.82,28
2023-05-18 16:30:00+01:00,12,29,0,17,13729.83,17
2023-05-18 17:30:00+01:00,13,36,0,23,13746.99,23
2023-05-18 18:30:00+01:00,11,36,0,25,13734.17,25
2023-05-18 19:30:00+01:00,11,40,0,29,13791.18,29
2023-05-18 20:30:00+01:00,6,51,0,45,13836.04,45
2023-05-19 14:30:00+01:00,3,47,0,44,13842.55,44
2023-05-19 15:30:00+01:00,3,37,0,34,13805.42,34
2023-05-19 16:30:00+01:00,4,32,0,28,13795.94,28
2023-05-19 17:30:00+01:00,4,22,0,18,13813.64,18
2023-05-19 18:30:00+01:00,4,27,0,23,13775.82,23
2023-05-19 19:30:00+01:00,5,27,0,22,13785.21,22
2023-05-19 20:30:00+01:00,4,27,0,23,13804.10,23
2023-05-22 14:30:00+01:00,3,20,0,17,13852.71,17
2023-05-22 15:30:00+01:00,7,19,0,12,13860.69,12
2023-05-22 16:30:00+01:00,7,24,0,17,13832.16,17
2023-05-22 17:30:00+01:00,6,26,0,20,13852.99,20
2023-05-22 18:30:00+01:00,5,30,0,25,13867.92,25
2023-05-22 19:30:00+01:00,12,22,0,10,13851.56,10
2023-05-22 20:30:00+01:00,15,14,1,0,13850.24,-1
2023-05-23 14:30:00+01:00,26,8,18,0,13806.13,-18
2023-05-23 15:30:00+01:00,20,17,3,0,13817.54,-3
2023-05-23 16:30:00+01:00,23,13,10,0,13784.42,-10
2023-05-23 17:30:00+01:00,26,5,21,0,13738.38,-21
2023-05-23 18:30:00+01:00,27,6,21,0,13682.41,-21
2023-05-23 19:30:00+01:00,28,5,23,0,13688.61,-23
2023-05-23 20:30:00+01:00,33,3,30,0,13675.44,-30
2023-05-24 14:30:00+01:00,56,1,55,0,13545.92,-55
2023-05-24 15:30:00+01:00,49,2,47,0,13569.15,-47
2023-05-24 16:30:00+01:00,52,2,50,0,13536.06,-50
2023-05-24 17:30:00+01:00,53,1,52,0,13556.89,-52
2023-05-24 18:30:00+01:00,55,1,54,0,13562.23,-54
2023-05-24 19:30:00+01:00,42,1,41,0,13633.20,-41
2023-05-24 20:30:00+01:00,47,3,44,0,13603.65,-44
2023-05-25 14:30:00+01:00,39,4,35,0,13846.47,-35
2023-05-25 15:30:00+01:00,38,6,32,0,13923.56,-32
2023-05-25 16:30:00+01:00,30,6,24,0,13951.91,-24
2023-05-25 17:30:00+01:00,28,14,14,0,13950.61,-14
2023-05-25 18:30:00+01:00,23,18,5,0,13956.50,-5
2023-05-25 19:30:00+01:00,22,17,5,0,13971.29,-5
2023-05-25 20:30:00+01:00,23,16,7,0,13937.11,-7
2023-05-26 14:30:00+01:00,9,46,0,37,14163.96,37
2023-05-26 15:30:00+01:00,12,42,0,30,14206.58,30
2023-05-26 16:30:00+01:00,9,49,0,40,14263.28,40
2023-05-26 17:30:00+01:00,10,46,0,36,14280.06,36
2023-05-26 18:30:00+01:00,8,44,0,36,14284.95,36
2023-05-26 19:30:00+01:00,12,39,0,27,14306.70,27
2023-05-26 20:30:00+01:00,10,40,0,30,14297.17,30
2023-05-30 14:30:00+01:00,7,39,0,32,14388.36,32
2023-05-30 15:30:00+01:00,6,41,0,35,14415.09,35
2023-05-30 16:30:00+01:00,7,38,0,31,14376.00,31
2023-05-30 17:30:00+01:00,7,35,0,28,14350.06,28
2023-05-30 18:30:00+01:00,7,34,0,27,14364.41,27
2023-05-30 19:30:00+01:00,9,36,0,27,14379.23,27
2023-05-30 20:30:00+01:00,3,36,0,33,14354.83,33
2023-05-31 14:30:00+01:00,19,8,11,0,14261.02,-11
2023-05-31 15:30:00+01:00,19,8,11,0,14232.79,-11
2023-05-31 16:30:00+01:00,17,6,11,0,14229.26,-11
2023-05-31 17:30:00+01:00,15,11,4,0,14278.23,-4
2023-05-31 18:30:00+01:00,12,11,1,0,14310.65,-1
2023-05-31 19:30:00+01:00,16,12,4,0,14279.74,-4
2023-05-31 20:30:00+01:00,17,11,6,0,14259.15,-6
2023-06-01 14:30:00+01:00,11,10,1,0,14269.81,-1
2023-06-01 15:30:00+01:00,9,14,0,5,14351.44,5
2023-06-01 16:30:00+01:00,6,20,0,14,14419.63,14
2023-06-01 17:30:00+01:00,6,20,0,14,14419.46,14
2023-06-01 18:30:00+01:00,4,16,0,12,14456.46,12
2023-06-01 19:30:00+01:00,4,16,0,12,14449.60,12
2023-06-01 20:30:00+01:00,6,14,0,8,14439.53,8
2023-06-02 14:30:00+01:00,4,43,0,39,14494.31,39
2023-06-02 15:30:00+01:00,3,48,0,45,14559.18,45
2023-06-02 16:30:00+01:00,4,45,0,41,14540.72,41
2023-06-02 17:30:00+01:00,3,42,0,39,14569.21,39
2023-06-02 18:30:00+01:00,6,35,0,29,14543.09,29
2023-06-02 19:30:00+01:00,4,36,0,32,14546.66,32
2023-06-02 20:30:00+01:00,3,40,0,37,14542.85,37
2023-06-05 14:30:00+01:00,0,36,0,36,14578.71,36
2023-06-05 15:30:00+01:00,2,35,0,33,14645.03,33
2023-06-05 16:30:00+01:00,4,34,0,30,14648.88,30
2023-06-05 17:30:00+01:00,3,28,0,25,14620.75,25
2023-06-05 18:30:00+01:00,10,25,0,15,14585.70,15
2023-06-05 19:30:00+01:00,10,27,0,17,14562.48,17
2023-06-05 20:30:00+01:00,8,28,0,20,14559.39,20
2023-06-06 14:30:00+01:00,9,18,0,9,14542.18,9
2023-06-06 15:30:00+01:00,7,13,0,6,14533.57,6
2023-06-06 16:30:00+01:00,10,16,0,6,14564.70,6
2023-06-06 17:30:00+01:00,14,10,4,0,14542.81,-4
2023-06-06 18:30:00+01:00,9,14,0,5,14546.33,5
2023-06-06 19:30:00+01:00,11,12,0,1,14560.57,1
2023-06-06 20:30:00+01:00,10,14,0,4,14558.47,4
2023-06-07 14:30:00+01:00,14,17,0,3,14524.51,3
2023-06-07 15:30:00+01:00,22,12,10,0,14462.13,-10
2023-06-07 16:30:00+01:00,34,5,29,0,14363.07,-29
2023-06-07 17:30:00+01:00,31,6,25,0,14354.22,-25
2023-06-07 18:30:00+01:00,33,7,26,0,14361.39,-26
2023-06-07 19:30:00+01:00,38,9,29,0,14331.14,-29
2023-06-07 20:30:00+01:00,39,8,31,0,14304.85,-31
2023-06-08 14:30:00+01:00,26,6,20,0,14394.86,-20
2023-06-08 15:30:00+01:00,20,5,15,0,14470.43,-15
2023-06-08 16:30:00+01:00,17,6,11,0,14502.68,-11
2023-06-08 17:30:00+01:00,16,12,4,0,14443.54,-4
2023-06-08 18:30:00+01:00,15,9,6,0,14448.88,-6
2023-06-08 19:30:00+01:00,14,11,3,0,14470.45,-3
2023-06-08 20:30:00+01:00,12,9,3,0,14483.44,-3
2023-06-09 14:30:00+01:00,3,10,0,7,14656.73,7
2023-06-09 15:30:00+01:00,8,6,2,0,14540.93,-2
2023-06-09 16:30:00+01:00,2,10,0,8,14507.81,8
2023-06-09 17:30:00+01:00,2,15,0,13,14569.26,13
2023-06-09 18:30:00+01:00,3,17,0,14,14580.87,14
2023-06-09 19:30:00+01:00,3,17,0,14,14550.65,14
2023-06-09 20:30:00+01:00,3,18,0,15,14529.49,15
2023-06-12 14:30:00+01:00,5,21,0,16,14612.03,16
2023-06-12 15:30:00+01:00,5,13,0,8,14621.06,8
2023-06-12 16:30:00+01:00,4,12,0,8,14650.01,8
2023-06-12 17:30:00+01:00,6,17,0,11,14659.91,11
2023-06-12 18:30:00+01:00,7,19,0,12,14692.96,12
2023-06-12 19:30:00+01:00,3,21,0,18,14756.93,18
2023-06-12 20:30:00+01:00,4,30,0,26,14785.24,26
2023-06-13 14:30:00+01:00,1,27,0,26,14799.83,26
2023-06-13 15:30:00+01:00,1,59,0,58,14895.37,58
2023-06-13 16:30:00+01:00,0,61,0,61,14873.80,61
2023-06-13 17:30:00+01:00,0,57,0,57,14893.38,57
2023-06-13 18:30:00+01:00,1,45,0,44,14832.72,44
2023-06-13 19:30:00+01:00,2,51,0,49,14875.44,49
2023-06-13 20:30:00+01:00,0,56,0,56,14904.23,56
2023-06-14 14:30:00+01:00,1,49,0,48,14951.32,48
2023-06-14 15:30:00+01:00,1,51,0,50,15000.93,50
2023-06-14 16:30:00+01:00,1,40,0,39,14982.48,39
2023-06-14 17:30:00+01:00,2,36,0,34,14941.63,34
2023-06-14 18:30:00+01:00,2,17,0,15,14846.53,15
2023-06-14 19:30:00+01:00,2,22,0,20,14950.97,20
2023-06-14 20:30:00+01:00,4,20,0,16,15006.08,16
2023-06-15 14:30:00+01:00,3,26,0,23,15075.49,23
2023-06-15 15:30:00+01:00,1,22,0,21,15105.72,21
2023-06-15 16:30:00+01:00,2,25,0,23,15111.80,23
2023-06-15 17:30:00+01:00,2,25,0,23,15115.15,23
2023-06-15 18:30:00+01:00,1,33,0,32,15164.12,32
2023-06-15 19:30:00+01:00,2,39,0,37,15218.64,37
2023-06-15 20:30:00+01:00,2,32,0,30,15186.40,30
2023-06-16 14:30:00+01:00,1,36,0,35,15225.60,35
2023-06-16 15:30:00+01:00,4,16,0,12,15160.22,12
2023-06-16 16:30:00+01:00,1,14,0,13,15203.11,13
2023-06-16 17:30:00+01:00,1,19,0,18,15187.26,18
2023-06-16 18:30:00+01:00,0,39,0,39,15169.82,39
2023-06-16 19:30:00+01:00,2,20,0,18,15111.46,18
2023-06-16 20:30:00+01:00,7,19,0,12,15085.00,12
2023-06-20 14:30:00+01:00,15,4,11,0,14957.01,-11
2023-06-20 15:30:00+01:00,18,2,16,0,14994.33,-16
2023-06-20 16:30:00+01:00,12,2,10,0,15059.18,-10
2023-06-20 17:30:00+01:00,10,4,6,0,15084.37,-6
2023-06-20 18:30:00+01:00,18,3,15,0,15085.04,-15
2023-06-20 19:30:00+01:00,32,3,29,0,15069.52,-29
2023-06-20 20:30:00+01:00,28,2,26,0,15074.07,-26
2023-06-21 14:30:00+01:00,48,1,47,0,14919.26,-47
2023-06-21 15:30:00+01:00,47,1,46,0,14865.67,-46
2023-06-21 16:30:00+01:00,46,1,45,0,14890.73,-45
2023-06-21 17:30:00+01:00,46,1,45,0,14872.81,-45
2023-06-21 18:30:00+01:00,35,3,32,0,14954.13,-32
2023-06-21 19:30:00+01:00,34,4,30,0,14919.40,-30
2023-06-21 20:30:00+01:00,34,5,29,0,14865.77,-29
2023-06-22 14:30:00+01:00,14,6,8,0,14964.38,-8
2023-06-22 15:30:00+01:00,17,6,11,0,14939.15,-11
2023-06-22 16:30:00+01:00,23,5,18,0,14952.82,-18
2023-06-22 17:30:00+01:00,27,3,24,0,14946.20,-24
2023-06-22 18:30:00+01:00,20,5,15,0,14983.37,-15
2023-06-22 19:30:00+01:00,22,5,17,0,14986.99,-17
2023-06-22 20:30:00+01:00,18,7,11,0,15043.00,-11
2023-06-23 14:30:00+01:00,23,5,18,0,14878.65,-18
2023-06-23 15:30:00+01:00,22,2,20,0,14849.91,-20
2023-06-23 16:30:00+01:00,17,3,14,0,14941.04,-14
2023-06-23 17:30:00+01:00,14,2,12,0,14973.43,-12
2023-06-23 18:30:00+01:00,25,0,25,0,14936.64,-25
2023-06-23 19:30:00+01:00,25,1,24,0,14893.55,-24
2023-06-23 20:30:00+01:00,20,2,18,0,14889.38,-18
2023-06-26 14:30:00+01:00,16,3,13,0,14956.32,-13
2023-06-26 15:30:00+01:00,14,3,11,0,14832.82,-11
2023-06-26 16:30:00+01:00,14,2,12,0,14749.36,-12
2023-06-26 17:30:00+01:00,13,3,10,0,14757.36,-10
2023-06-26 18:30:00+01:00,20,2,18,0,14744.07,-18
2023-06-26 19:30:00+01:00,20,2,18,0,14755.67,-18
2023-06-26 20:30:00+01:00,22,1,21,0,14691.21,-21
2023-06-27 14:30:00+01:00,12,13,0,1,14767.77,1
2023-06-27 15:30:00+01:00,9,20,0,11,14813.28,11
2023-06-27 16:30:00+01:00,11,19,0,8,14861.54,8
2023-06-27 17:30:00+01:00,6,21,0,15,14905.81,15
2023-06-27 18:30:00+01:00,5,27,0,22,14956.11,22
2023-06-27 19:30:00+01:00,5,32,0,27,14971.77,27
2023-06-27 20:30:00+01:00,6,29,0,23,14945.42,23
2023-06-28 14:30:00+01:00,3,15,0,12,14975.63,12
2023-06-28 15:30:00+01:00,2,22,0,20,14978.29,20
2023-06-28 16:30:00+01:00,4,26,0,22,14981.74,22
2023-06-28 17:30:00+01:00,6,20,0,14,14958.22,14
2023-06-28 18:30:00+01:00,4,29,0,25,14972.44,25
2023-06-28 19:30:00+01:00,5,21,0,16,14940.62,16
2023-06-28 20:30:00+01:00,4,38,0,34,14968.41,34
2023-06-29 14:30:00+01:00,7,23,0,16,14908.02,16
2023-06-29 15:30:00+01:00,6,23,0,17,14972.21,17
2023-06-29 16:30:00+01:00,8,18,0,10,14957.83,10
2023-06-29 17:30:00+01:00,9,14,0,5,14939.83,5
2023-06-29 18:30:00+01:00,13,9,4,0,14913.45,-4
2023-06-29 19:30:00+01:00,14,9,5,0,14919.75,-5
2023-06-29 20:30:00+01:00,14,14,0,0,14940.00,0
2023-06-30 14:30:00+01:00,2,22,0,20,15193.23,20
2023-06-30 15:30:00+01:00,2,27,0,25,15169.95,25
2023-06-30 16:30:00+01:00,1,28,0,27,15168.17,27
2023-06-30 17:30:00+01:00,3,36,0,33,15185.12,33
2023-06-30 18:30:00+01:00,2,41,0,39,15201.19,39
2023-06-30 19:30:00+01:00,2,40,0,38,15197.27,38
2023-06-30 20:30:00+01:00,2,32,0,30,15175.63,30
2023-07-03 14:30:00+01:00,2,37,0,35,15199.84,35
2023-07-03 15:30:00+01:00,3,27,0,24,15166.30,24
2023-07-03 16:30:00+01:00,2,32,0,30,15184.14,30
2023-07-05 14:30:00+01:00,3,24,0,21,15254.25,21
2023-07-05 15:30:00+01:00,2,26,0,24,15208.17,24
2023-07-05 16:30:00+01:00,2,23,0,21,15215.29,21
2023-07-05 17:30:00+01:00,2,21,0,19,15212.43,19
2023-07-05 18:30:00+01:00,12,7,5,0,15189.59,-5
2023-07-05 19:30:00+01:00,9,12,0,3,15229.70,3
2023-07-05 20:30:00+01:00,11,11,0,0,15202.75,0
2023-07-06 14:30:00+01:00,39,2,37,0,15020.19,-37
2023-07-06 15:30:00+01:00,42,3,39,0,14993.59,-39
2023-07-06 16:30:00+01:00,30,2,28,0,15057.97,-28
2023-07-06 17:30:00+01:00,24,2,22,0,15066.08,-22
2023-07-06 18:30:00+01:00,26,2,24,0,15072.74,-24
2023-07-06 19:30:00+01:00,20,2,18,0,15090.91,-18
2023-07-06 20:30:00+01:00,27,2,25,0,15089.12,-25
2023-07-07 14:30:00+01:00,21,2,19,0,15081.99,-19
2023-07-07 15:30:00+01:00,17,0,17,0,15105.81,-17
2023-07-07 16:30:00+01:00,14,1,13,0,15151.31,-13
2023-07-07 17:30:00+01:00,8,3,5,0,15208.76,-5
2023-07-07 18:30:00+01:00,11,3,8,0,15180.75,-8
2023-07-07 19:30:00+01:00,16,1,15,0,15107.20,-15
2023-07-07 20:30:00+01:00,22,1,21,0,15035.56,-21
2023-07-10 14:30:00+01:00,3,31,0,28,15034.44,28
2023-07-10 15:30:00+01:00,5,44,0,39,15011.92,39
2023-07-10 16:30:00+01:00,10,39,0,29,14964.99,29
2023-07-10 17:30:00+01:00,10,38,0,28,15022.08,28
2023-07-10 18:30:00+01:00,9,37,0,28,15044.56,28
2023-07-10 19:30:00+01:00,10,36,0,26,15027.36,26
2023-07-10 20:30:00+01:00,8,35,0,27,15046.32,27
2023-07-11 14:30:00+01:00,6,28,0,22,15032.82,22
2023-07-11 15:30:00+01:00,6,30,0,24,15041.14,24
2023-07-11 16:30:00+01:00,9,28,0,19,15052.11,19
2023-07-11 17:30:00+01:00,9,24,0,15,15057.68,15
2023-07-11 18:30:00+01:00,9,23,0,14,15037.88,14
2023-07-11 19:30:00+01:00,6,38,0,32,15077.28,32
2023-07-11 20:30:00+01:00,4,50,0,46,15118.76,46
2023-07-12 14:30:00+01:00,1,53,0,52,15344.92,52
2023-07-12 15:30:00+01:00,3,44,0,41,15308.02,41
2023-07-12 16:30:00+01:00,3,28,0,25,15249.34,25
2023-07-12 17:30:00+01:00,2,30,0,28,15299.49,28
2023-07-12 18:30:00+01:00,2,33,0,31,15332.64,31
2023-07-12 19:30:00+01:00,2,30,0,28,15300.44,28
2023-07-12 20:30:00+01:00,4,32,0,28,15309.79,28
2023-07-13 14:30:00+01:00,2,50,0,48,15428.04,48
2023-07-13 15:30:00+01:00,3,49,0,46,15462.90,46
2023-07-13 16:30:00+01:00,3,54,0,51,15508.33,51
2023-07-13 17:30:00+01:00,2,51,0,49,15523.37,49
2023-07-13 18:30:00+01:00,2,55,0,53,15531.59,53
2023-07-13 19:30:00+01:00,2,55,0,53,15581.01,53
2023-07-13 20:30:00+01:00,2,51,0,49,15572.04,49
2023-07-14 14:30:00+01:00,9,30,0,21,15684.45,21
2023-07-14 15:30:00+01:00,6,31,0,25,15670.79,25
2023-07-14 16:30:00+01:00,4,42,0,38,15639.87,38
2023-07-14 17:30:00+01:00,6,37,0,31,15617.80,31
2023-07-14 18:30:00+01:00,6,30,0,24,15582.50,24
2023-07-14 19:30:00+01:00,4,31,0,27,15539.20,27
2023-07-14 20:30:00+01:00,4,31,0,27,15565.40,27
2023-07-17 14:30:00+01:00,3,26,0,23,15620.08,23
2023-07-17 15:30:00+01:00,7,25,0,18,15646.60,18
2023-07-17 16:30:00+01:00,5,26,0,21,15639.95,21
2023-07-17 17:30:00+01:00,3,26,0,23,15655.47,23
2023-07-17 18:30:00+01:00,1,28,0,27,15696.43,27
2023-07-17 19:30:00+01:00,4,34,0,30,15733.94,30
2023-07-17 20:30:00+01:00,5,27,0,22,15709.83,22
2023-07-18 14:30:00+01:00,6,24,0,18,15638.63,18
2023-07-18 15:30:00+01:00,11,23,0,12,15653.95,12
2023-07-18 16:30:00+01:00,10,16,0,6,15776.11,6
2023-07-18 17:30:00+01:00,12,17,0,5,15805.34,5
2023-07-18 18:30:00+01:00,8,22,0,14,15864.95,14
2023-07-18 19:30:00+01:00,7,33,0,26,15877.06,26
2023-07-18 20:30:00+01:00,6,29,0,23,15842.07,23
2023-07-19 14:30:00+01:00,4,26,0,22,15858.87,22
2023-07-19 15:30:00+01:00,3,19,0,16,15902.38,16
2023-07-19 16:30:00+01:00,4,14,0,10,15849.96,10
2023-07-19 17:30:00+01:00,8,8,0,0,15813.25,0
2023-07-19 18:30:00+01:00,12,8,4,0,15793.59,-4
2023-07-19 19:30:00+01:00,8,7,1,0,15852.83,-1
2023-07-19 20:30:00+01:00,10,8,2,0,15825.89,-2
2023-07-20 14:30:00+01:00,11,3,8,0,15627.09,-8
2023-07-20 15:30:00+01:00,10,3,7,0,15623.36,-7
2023-07-20 16:30:00+01:00,13,19,0,6,15593.91,6
2023-07-20 17:30:00+01:00,13,19,0,6,15586.56,6
2023-07-20 18:30:00+01:00,26,14,12,0,15497.13,-12
2023-07-20 19:30:00+01:00,29,14,15,0,15435.33,-15
2023-07-20 20:30:00+01:00,30,10,20,0,15469.77,-20
2023-07-21 14:30:00+01:00,34,12,22,0,15435.91,-22
2023-07-21 15:30:00+01:00,26,12,14,0,15515.62,-14
2023-07-21 16:30:00+01:00,19,14,5,0,15459.91,-5
2023-07-21 17:30:00+01:00,12,12,0,0,15508.63,0
2023-07-21 18:30:00+01:00,13,13,0,0,15481.12,0
2023-07-21 19:30:00+01:00,27,15,12,0,15434.32,-12
2023-07-21 20:30:00+01:00,22,13,9,0,15426.36,-9
2023-07-24 14:30:00+01:00,10,3,7,0,15468.11,-7
2023-07-24 15:30:00+01:00,8,5,3,0,15444.66,-3
2023-07-24 16:30:00+01:00,8,7,1,0,15443.40,-1
2023-07-24 17:30:00+01:00,8,5,3,0,15442.65,-3
2023-07-24 18:30:00+01:00,6,14,0,8,15465.95,8
2023-07-24 19:30:00+01:00,4,12,0,8,15416.00,8
2023-07-24 20:30:00+01:00,3,14,0,11,15449.10,11
2023-07-25 14:30:00+01:00,11,18,0,7,15521.54,7
2023-07-25 15:30:00+01:00,10,16,0,6,15537.89,6
2023-07-25 16:30:00+01:00,8,16,0,8,15556.35,8
2023-07-25 17:30:00+01:00,9,15,0,6,15593.25,6
2023-07-25 18:30:00+01:00,5,18,0,13,15598.81,13
2023-07-25 19:30:00+01:00,4,19,0,15,15591.55,15
2023-07-25 20:30:00+01:00,4,18,0,14,15564.32,14
2023-07-26 14:30:00+01:00,8,19,0,11,15498.46,11
2023-07-26 15:30:00+01:00,10,12,0,2,15443.94,2
2023-07-26 16:30:00+01:00,10,14,0,4,15450.98,4
2023-07-26 17:30:00+01:00,8,16,0,8,15451.34,8
2023-07-26 18:30:00+01:00,10,12,0,2,15452.18,2
2023-07-26 19:30:00+01:00,8,16,0,8,15466.23,8
2023-07-26 20:30:00+01:00,7,17,0,10,15501.40,10
2023-07-27 14:30:00+01:00,10,18,0,8,15668.15,8
2023-07-27 15:30:00+01:00,13,20,0,7,15717.95,7
2023-07-27 16:30:00+01:00,12,21,0,9,15744.36,9
2023-07-27 17:30:00+01:00,17,14,3,0,15639.84,-3
2023-07-27 18:30:00+01:00,28,8,20,0,15516.92,-20
2023-07-27 19:30:00+01:00,31,8,23,0,15472.10,-23
2023-07-27 20:30:00+01:00,31,9,22,0,15466.30,-22
2023-07-28 14:30:00+01:00,10,15,0,5,15691.73,5
2023-07-28 15:30:00+01:00,11,21,0,10,15757.54,10
2023-07-28 16:30:00+01:00,11,19,0,8,15785.09,8
2023-07-28 17:30:00+01:00,10,17,0,7,15725.33,7
2023-07-28 18:30:00+01:00,10,18,0,8,15752.30,8
2023-07-28 19:30:00+01:00,10,17,0,7,15743.01,7
2023-07-28 20:30:00+01:00,11,17,0,6,15745.97,6
2023-07-31 14:30:00+01:00,15,14,1,0,15759.59,-1
2023-07-31 15:30:00+01:00,13,10,3,0,15753.84,-3
2023-07-31 16:30:00+01:00,14,8,6,0,15758.49,-6
2023-07-31 17:30:00+01:00,11,13,0,2,15730.46,2
2023-07-31 18:30:00+01:00,4,30,0,26,15731.97,26
2023-07-31 19:30:00+01:00,4,37,0,33,15730.82,33
2023-07-31 20:30:00+01:00,3,40,0,37,15759.04,37
2023-08-01 14:30:00+01:00,15,15,0,0,15683.67,0
2023-08-01 15:30:00+01:00,18,14,4,0,15724.87,-4
2023-08-01 16:30:00+01:00,16,8,8,0,15699.49,-8
2023-08-01 17:30:00+01:00,15,12,3,0,15720.93,-3
2023-08-01 18:30:00+01:00,17,13,4,0,15733.29,-4
2023-08-01 19:30:00+01:00,15,13,2,0,15735.53,-2
2023-08-01 20:30:00+01:00,17,13,4,0,15718.50,-4
2023-08-02 14:30:00+01:00,40,4,36,0,15456.99,-36
2023-08-02 15:30:00+01:00,48,7,41,0,15412.81,-41
2023-08-02 16:30:00+01:00,51,8,43,0,15335.59,-43
2023-08-02 17:30:00+01:00,42,8,34,0,15398.64,-34
2023-08-02 18:30:00+01:00,38,3,35,0,15405.74,-35
2023-08-02 19:30:00+01:00,47,3,44,0,15342.84,-44
2023-08-02 20:30:00+01:00,47,3,44,0,15374.23,-44
2023-08-03 14:30:00+01:00,45,5,40,0,15273.82,-40
2023-08-03 15:30:00+01:00,34,4,30,0,15378.35,-30
2023-08-03 16:30:00+01:00,27,7,20,0,15387.84,-20
2023-08-03 17:30:00+01:00,31,5,26,0,15408.26,-26
2023-08-03 18:30:00+01:00,33,4,29,0,15382.51,-29
2023-08-03 19:30:00+01:00,42,3,39,0,15357.24,-39
2023-08-03 20:30:00+01:00,37,3,34,0,15351.66,-34
2023-08-04 14:30:00+01:00,16,10,6,0,15383.02,-6
2023-08-04 15:30:00+01:00,19,13,6,0,15457.69,-6
2023-08-04 16:30:00+01:00,14,25,0,11,15505.08,11
2023-08-04 17:30:00+01:00,17,15,2,0,15466.64,-2
2023-08-04 18:30:00+01:00,22,7,15,0,15346.68,-15
2023-08-04 19:30:00+01:00,19,7,12,0,15294.64,-12
2023-08-04 20:30:00+01:00,24,8,16,0,15275.56,-16
2023-08-07 14:30:00+01:00,10,13,0,3,15343.96,3
2023-08-07 15:30:00+01:00,19,7,12,0,15280.29,-12
2023-08-07 16:30:00+01:00,17,7,10,0,15339.60,-10
2023-08-07 17:30:00+01:00,17,6,11,0,15342.78,-11
2023-08-07 18:30:00+01:00,18,6,12,0,15346.19,-12
2023-08-07 19:30:00+01:00,13,5,8,0,15363.82,-8
2023-08-07 20:30:00+01:00,9,7,2,0,15408.63,-2
2023-08-08 14:30:00+01:00,20,4,16,0,15212.35,-16
2023-08-08 15:30:00+01:00,28,2,26,0,15187.53,-26
2023-08-08 16:30:00+01:00,35,1,34,0,15191.91,-34
2023-08-08 17:30:00+01:00,29,2,27,0,15209.84,-27
2023-08-08 18:30:00+01:00,17,4,13,0,15235.72,-13
2023-08-08 19:30:00+01:00,10,9,1,0,15258.46,-1
2023-08-08 20:30:00+01:00,11,11,0,0,15273.75,0
2023-08-09 14:30:00+01:00,16,5,11,0,15207.55,-11
2023-08-09 15:30:00+01:00,17,9,8,0,15095.28,-8
2023-08-09 16:30:00+01:00,21,6,15,0,15125.86,-15
2023-08-09 17:30:00+01:00,14,7,7,0,15170.92,-7
2023-08-09 18:30:00+01:00,10,8,2,0,15215.77,-2
2023-08-09 19:30:00+01:00,13,8,5,0,15174.72,-5
2023-08-09 20:30:00+01:00,34,5,29,0,15105.64,-29
2023-08-10 14:30:00+01:00,2,36,0,34,15324.80,34
2023-08-10 15:30:00+01:00,4,14,0,10,15224.36,10
2023-08-10 16:30:00+01:00,4,6,0,2,15160.42,2
2023-08-10 17:30:00+01:00,4,3,1,0,15131.83,-1
2023-08-10 18:30:00+01:00,5,1,4,0,15140.50,-4
2023-08-10 19:30:00+01:00,7,2,5,0,15135.19,-5
2023-08-10 20:30:00+01:00,6,1,5,0,15129.79,-5
2023-08-11 14:30:00+01:00,11,3,8,0,15076.89,-8
2023-08-11 15:30:00+01:00,12,2,10,0,14990.55,-10
2023-08-11 16:30:00+01:00,11,2,9,0,15014.70,-9
2023-08-11 17:30:00+01:00,12,1,11,0,15033.21,-11
2023-08-11 18:30:00+01:00,16,1,15,0,15043.84,-15
2023-08-11 19:30:00+01:00,14,2,12,0,15048.97,-12
2023-08-11 20:30:00+01:00,13,5,8,0,15029.95,-8
2023-08-14 14:30:00+01:00,37,2,35,0,15078.33,-35
2023-08-14 15:30:00+01:00,20,2,18,0,15151.09,-18
2023-08-14 16:30:00+01:00,15,8,7,0,15123.69,-7
2023-08-14 17:30:00+01:00,10,9,1,0,15162.11,-1
2023-08-14 18:30:00+01:00,13,11,2,0,15146.79,-2
2023-08-14 19:30:00+01:00,12,9,3,0,15157.40,-3
2023-08-14 20:30:00+01:00,6,15,0,9,15205.89,9
2023-08-15 14:30:00+01:00,11,5,6,0,15071.19,-6
2023-08-15 15:30:00+01:00,6,14,0,8,15109.32,8
2023-08-15 16:30:00+01:00,9,13,0,4,15117.82,4
2023-08-15 17:30:00+01:00,13,10,3,0,15113.61,-3
2023-08-15 18:30:00+01:00,15,12,3,0,15082.44,-3
2023-08-15 19:30:00+01:00,21,6,15,0,15025.94,-15
2023-08-15 20:30:00+01:00,16,6,10,0,15041.02,-10
2023-08-16 14:30:00+01:00,14,6,8,0,15039.29,-8
2023-08-16 15:30:00+01:00,19,4,15,0,15032.14,-15
2023-08-16 16:30:00+01:00,29,2,27,0,14947.64,-27
2023-08-16 17:30:00+01:00,33,1,32,0,14950.42,-32
2023-08-16 18:30:00+01:00,21,1,20,0,15003.32,-20
2023-08-16 19:30:00+01:00,38,1,37,0,14901.66,-37
2023-08-16 20:30:00+01:00,54,0,54,0,14876.71,-54
2023-08-17 14:30:00+01:00,34,3,31,0,14828.89,-31
2023-08-17 15:30:00+01:00,46,1,45,0,14812.08,-45
2023-08-17 16:30:00+01:00,29,4,25,0,14878.90,-25
2023-08-17 17:30:00+01:00,36,2,34,0,14848.06,-34
2023-08-17 18:30:00+01:00,35,1,34,0,14801.26,-34
2023-08-17 19:30:00+01:00,37,3,34,0,14736.57,-34
2023-08-17 20:30:00+01:00,42,3,39,0,14714.16,-39
2023-08-18 14:30:00+01:00,58,1,57,0,14585.08,-57
2023-08-18 15:30:00+01:00,56,1,55,0,14619.71,-55
2023-08-18 16:30:00+01:00,42,1,41,0,14654.85,-41
2023-08-18 17:30:00+01:00,42,2,40,0,14650.78,-40
2023-08-18 18:30:00+01:00,44,1,43,0,14683.04,-43
2023-08-18 19:30:00+01:00,30,4,26,0,14698.59,-26
2023-08-18 20:30:00+01:00,28,4,24,0,14695.11,-24
2023-08-21 14:30:00+01:00,26,8,18,0,14779.59,-18
2023-08-21 15:30:00+01:00,24,11,13,0,14759.71,-13
2023-08-21 16:30:00+01:00,26,11,15,0,14821.28,-15
2023-08-21 17:30:00+01:00,16,12,4,0,14879.06,-4
2023-08-21 18:30:00+01:00,14,17,0,3,14903.25,3
2023-08-21 19:30:00+01:00,7,26,0,19,14936.61,19
2023-08-21 20:30:00+01:00,6,29,0,23,14936.78,23
2023-08-22 14:30:00+01:00,4,40,0,36,14958.24,36
2023-08-22 15:30:00+01:00,4,40,0,36,14968.58,36
2023-08-22 16:30:00+01:00,4,21,0,17,14911.62,17
2023-08-22 17:30:00+01:00,4,22,0,18,14908.56,18
2023-08-22 18:30:00+01:00,5,20,0,15,14927.09,15
2023-08-22 19:30:00+01:00,4,21,0,17,14917.88,17
2023-08-22 20:30:00+01:00,7,20,0,13,14909.83,13
2023-08-23 14:30:00+01:00,6,38,0,32,15076.62,32
2023-08-23 15:30:00+01:00,3,49,0,46,15140.09,46
2023-08-23 16:30:00+01:00,3,42,0,39,15124.29,39
2023-08-23 17:30:00+01:00,4,41,0,37,15168.55,37
2023-08-23 18:30:00+01:00,4,39,0,35,15159.38,35
2023-08-23 19:30:00+01:00,3,36,0,33,15177.97,33
2023-08-23 20:30:00+01:00,4,30,0,26,15147.77,26
2023-08-24 14:30:00+01:00,3,17,0,14,15032.44,14
2023-08-24 15:30:00+01:00,6,7,0,1,14972.23,1
2023-08-24 16:30:00+01:00,5,8,0,3,14951.57,3
2023-08-24 17:30:00+01:00,7,6,1,0,14927.50,-1
2023-08-24 18:30:00+01:00,9,6,3,0,14927.72,-3
2023-08-24 19:30:00+01:00,13,7,6,0,14877.71,-6
2023-08-24 20:30:00+01:00,13,4,9,0,14815.94,-9
2023-08-25 14:30:00+01:00,29,1,28,0,14852.20,-28
2023-08-25 15:30:00+01:00,39,1,38,0,14818.59,-38
2023-08-25 16:30:00+01:00,37,2,35,0,14837.86,-35
2023-08-25 17:30:00+01:00,41,3,38,0,14826.31,-38
2023-08-25 18:30:00+01:00,26,3,23,0,14931.15,-23
2023-08-25 19:30:00+01:00,17,2,15,0,14972.49,-15
2023-08-25 20:30:00+01:00,17,3,14,0,14939.59,-14
2023-08-28 14:30:00+01:00,2,8,0,6,15049.86,6
2023-08-28 15:30:00+01:00,1,11,0,10,14977.61,10
2023-08-28 16:30:00+01:00,3,8,0,5,14967.20,5
2023-08-28 17:30:00+01:00,1,15,0,14,15044.18,14
2023-08-28 18:30:00+01:00,1,9,0,8,14985.33,8
2023-08-28 19:30:00+01:00,0,13,0,13,15009.72,13
2023-08-28 20:30:00+01:00,0,35,0,35,15054.45,35
2023-08-29 14:30:00+01:00,0,49,0,49,15252.00,49
2023-08-29 15:30:00+01:00,0,58,0,58,15304.72,58
2023-08-29 16:30:00+01:00,0,63,0,63,15345.36,63
2023-08-29 17:30:00+01:00,0,66,0,66,15338.55,66
2023-08-29 18:30:00+01:00,1,51,0,50,15356.31,50
2023-08-29 19:30:00+01:00,0,53,0,53,15388.52,53
2023-08-29 20:30:00+01:00,0,59,0,59,15380.14,59
2023-08-30 14:30:00+01:00,2,29,0,27,15369.81,27
2023-08-30 15:30:00+01:00,1,56,0,55,15427.38,55
2023-08-30 16:30:00+01:00,1,61,0,60,15472.31,60
2023-08-30 17:30:00+01:00,1,49,0,48,15461.08,48
2023-08-30 18:30:00+01:00,1,54,0,53,15421.52,53
2023-08-30 19:30:00+01:00,1,54,0,53,15457.93,53
2023-08-30 20:30:00+01:00,2,50,0,48,15462.93,48
2023-08-31 14:30:00+01:00,1,38,0,37,15559.67,37
2023-08-31 15:30:00+01:00,2,32,0,30,15536.45,30
2023-08-31 16:30:00+01:00,4,24,0,20,15503.04,20
2023-08-31 17:30:00+01:00,3,30,0,27,15538.29,27
2023-08-31 18:30:00+01:00,4,30,0,26,15553.35,26
2023-08-31 19:30:00+01:00,11,23,0,12,15539.15,12
2023-08-31 20:30:00+01:00,13,17,0,4,15505.51,4
2023-09-01 14:30:00+01:00,9,31,0,22,15550.84,22
2023-09-01 15:30:00+01:00,11,22,0,11,15478.32,11
2023-09-01 16:30:00+01:00,14,17,0,3,15470.28,3
2023-09-01 17:30:00+01:00,13,17,0,4,15461.83,4
2023-09-01 18:30:00+01:00,12,17,0,5,15442.85,5
2023-09-01 19:30:00+01:00,13,17,0,4,15482.34,4
2023-09-01 20:30:00+01:00,9,19,0,10,15488.90,10
2023-09-05 14:30:00+01:00,16,8,8,0,15464.61,-8
2023-09-05 15:30:00+01:00,13,11,2,0,15508.15,-2
2023-09-05 16:30:00+01:00,14,14,0,0,15515.16,0
2023-09-05 17:30:00+01:00,16,11,5,0,15502.87,-5
2023-09-05 18:30:00+01:00,13,13,0,0,15550.33,0
2023-09-05 19:30:00+01:00,12,11,1,0,15522.77,-1
2023-09-05 20:30:00+01:00,13,14,0,1,15506.09,1
2023-09-06 14:30:00+01:00,29,3,26,0,15366.05,-26
2023-09-06 15:30:00+01:00,22,4,18,0,15366.34,-18
2023-09-06 16:30:00+01:00,22,4,18,0,15316.14,-18
2023-09-06 17:30:00+01:00,23,4,19,0,15326.46,-19
2023-09-06 18:30:00+01:00,20,5,15,0,15346.63,-15
2023-09-06 19:30:00+01:00,24,3,21,0,15334.76,-21
2023-09-06 20:30:00+01:00,21,5,16,0,15373.88,-16
2023-09-07 14:30:00+01:00,31,2,29,0,15195.34,-29
2023-09-07 15:30:00+01:00,36,6,30,0,15214.48,-30
2023-09-07 16:30:00+01:00,24,10,14,0,15247.02,-14
2023-09-07 17:30:00+01:00,21,10,11,0,15251.70,-11
2023-09-07 18:30:00+01:00,28,8,20,0,15240.53,-20
2023-09-07 19:30:00+01:00,21,8,13,0,15267.97,-13
2023-09-07 20:30:00+01:00,22,6,16,0,15260.86,-16
2023-09-08 14:30:00+01:00,14,15,0,1,15360.82,1
2023-09-08 15:30:00+01:00,14,14,0,0,15341.99,0
2023-09-08 16:30:00+01:00,17,16,1,0,15326.76,-1
2023-09-08 17:30:00+01:00,17,16,1,0,15305.38,-1
2023-09-08 18:30:00+01:00,22,11,11,0,15280.63,-11
2023-09-08 19:30:00+01:00,22,7,15,0,15249.14,-15
2023-09-08 20:30:00+01:00,21,8,13,0,15281.89,-13
2023-09-11 14:30:00+01:00,4,26,0,22,15365.47,22
2023-09-11 15:30:00+01:00,7,21,0,14,15385.25,14
2023-09-11 16:30:00+01:00,16,17,0,1,15385.22,1
2023-09-11 17:30:00+01:00,14,19,0,5,15422.09,5
2023-09-11 18:30:00+01:00,5,24,0,19,15464.22,19
2023-09-11 19:30:00+01:00,7,25,0,18,15477.22,18
2023-09-11 20:30:00+01:00,4,22,0,18,15463.23,18
2023-09-12 14:30:00+01:00,14,15,0,1,15377.11,1
2023-09-12 15:30:00+01:00,19,15,4,0,15337.20,-4
2023-09-12 16:30:00+01:00,12,15,0,3,15358.13,3
2023-09-12 17:30:00+01:00,4,18,0,14,15392.92,14
2023-09-12 18:30:00+01:00,5,20,0,15,15332.73,15
2023-09-12 19:30:00+01:00,8,14,0,6,15285.94,6
2023-09-12 20:30:00+01:00,9,10,0,1,15292.60,1
2023-09-13 14:30:00+01:00,16,6,10,0,15322.01,-10
2023-09-13 15:30:00+01:00,13,9,4,0,15389.85,-4
2023-09-13 16:30:00+01:00,9,6,3,0,15385.90,-3
2023-09-13 17:30:00+01:00,10,4,6,0,15396.26,-6
2023-09-13 18:30:00+01:00,19,6,13,0,15388.24,-13
2023-09-13 19:30:00+01:00,22,4,18,0,15337.09,-18
2023-09-13 20:30:00+01:00,20,4,16,0,15347.48,-16
2023-09-14 14:30:00+01:00,14,8,6,0,15380.83,-6
2023-09-14 15:30:00+01:00,5,18,0,13,15462.66,13
2023-09-14 16:30:00+01:00,7,18,0,11,15469.82,11
2023-09-14 17:30:00+01:00,9,17,0,8,15490.16,8
2023-09-14 18:30:00+01:00,6,17,0,11,15463.88,11
2023-09-14 19:30:00+01:00,4,31,0,27,15480.49,27
2023-09-14 20:30:00+01:00,2,24,0,22,15474.31,22
2023-09-15 14:30:00+01:00,14,17,0,3,15308.99,3
2023-09-15 15:30:00+01:00,26,10,16,0,15243.28,-16
2023-09-15 16:30:00+01:00,25,11,14,0,15248.33,-14
2023-09-15 17:30:00+01:00,30,5,25,0,15194.50,-25
2023-09-15 18:30:00+01:00,29,5,24,0,15179.52,-24
2023-09-15 19:30:00+01:00,20,11,9,0,15209.58,-9
2023-09-15 20:30:00+01:00,20,6,14,0,15202.73,-14
2023-09-18 14:30:00+01:00,17,2,15,0,15220.82,-15
2023-09-18 15:30:00+01:00,24,1,23,0,15230.62,-23
2023-09-18 16:30:00+01:00,21,2,19,0,15260.77,-19
2023-09-18 17:30:00+01:00,29,1,28,0,15252.78,-28
2023-09-18 18:30:00+01:00,28,2,26,0,15240.81,-26
2023-09-18 19:30:00+01:00,40,0,40,0,15215.17,-40
2023-09-18 20:30:00+01:00,35,0,35,0,15225.96,-35
2023-09-19 14:30:00+01:00,33,1,32,0,15115.00,-32
2023-09-19 15:30:00+01:00,25,1,24,0,15097.94,-24
2023-09-19 16:30:00+01:00,27,1,26,0,15101.50,-26
2023-09-19 17:30:00+01:00,18,3,15,0,15137.21,-15
2023-09-19 18:30:00+01:00,18,4,14,0,15178.17,-14
2023-09-19 19:30:00+01:00,18,4,14,0,15176.43,-14
2023-09-19 20:30:00+01:00,17,6,11,0,15190.38,-11
2023-09-20 14:30:00+01:00,15,14,1,0,15188.48,-1
2023-09-20 15:30:00+01:00,14,12,2,0,15152.36,-2
2023-09-20 16:30:00+01:00,11,13,0,2,15190.07,2
2023-09-20 17:30:00+01:00,10,11,0,1,15185.34,1
2023-09-20 18:30:00+01:00,12,10,2,0,15150.96,-2
2023-09-20 19:30:00+01:00,16,7,9,0,15069.78,-9
2023-09-20 20:30:00+01:00,29,5,24,0,14969.12,-24
2023-09-21 14:30:00+01:00,30,3,27,0,14797.19,-27
2023-09-21 15:30:00+01:00,38,4,34,0,14774.90,-34
2023-09-21 16:30:00+01:00,38,2,36,0,14775.18,-36
2023-09-21 17:30:00+01:00,37,0,37,0,14816.63,-37
2023-09-21 18:30:00+01:00,47,1,46,0,14765.08,-46
2023-09-21 19:30:00+01:00,51,1,50,0,14727.43,-50
2023-09-21 20:30:00+01:00,63,0,63,0,14692.43,-63
2023-09-22 14:30:00+01:00,45,0,45,0,14784.35,-45
2023-09-22 15:30:00+01:00,34,1,33,0,14843.31,-33
2023-09-22 16:30:00+01:00,39,1,38,0,14833.77,-38
2023-09-22 17:30:00+01:00,47,0,47,0,14776.46,-47
2023-09-22 18:30:00+01:00,46,1,45,0,14722.43,-45
2023-09-22 19:30:00+01:00,30,0,30,0,14785.28,-30
2023-09-22 20:30:00+01:00,33,1,32,0,14701.37,-32
2023-09-25 14:30:00+01:00,21,5,16,0,14663.95,-16
2023-09-25 15:30:00+01:00,13,5,8,0,14730.98,-8
2023-09-25 16:30:00+01:00,12,7,5,0,14761.13,-5
2023-09-25 17:30:00+01:00,15,5,10,0,14720.57,-10
2023-09-25 18:30:00+01:00,12,4,8,0,14724.14,-8
2023-09-25 19:30:00+01:00,7,7,0,0,14722.87,0
2023-09-25 20:30:00+01:00,4,9,0,5,14768.11,5
2023-09-26 14:30:00+01:00,17,4,13,0,14603.95,-13
2023-09-26 15:30:00+01:00,30,3,27,0,14568.53,-27
2023-09-26 16:30:00+01:00,26,1,25,0,14603.00,-25
2023-09-26 17:30:00+01:00,17,2,15,0,14579.96,-15
2023-09-26 18:30:00+01:00,19,2,17,0,14546.79,-17
2023-09-26 19:30:00+01:00,38,2,36,0,14515.41,-36
2023-09-26 20:30:00+01:00,13,4,9,0,14547.52,-9
2023-09-27 14:30:00+01:00,9,10,0,1,14603.69,1
2023-09-27 15:30:00+01:00,16,11,5,0,14576.68,-5
2023-09-27 16:30:00+01:00,29,3,26,0,14503.13,-26
2023-09-27 17:30:00+01:00,31,4,27,0,14461.52,-27
2023-09-27 18:30:00+01:00,19,4,15,0,14513.70,-15
2023-09-27 19:30:00+01:00,14,5,9,0,14606.27,-9
2023-09-27 20:30:00+01:00,17,5,12,0,14580.59,-12
2023-09-28 14:30:00+01:00,13,8,5,0,14573.96,-5
2023-09-28 15:30:00+01:00,11,14,0,3,14667.75,3
2023-09-28 16:30:00+01:00,9,24,0,15,14784.64,15
2023-09-28 17:30:00+01:00,7,17,0,10,14718.86,10
2023-09-28 18:30:00+01:00,7,18,0,11,14720.34,11
2023-09-28 19:30:00+01:00,7,32,0,25,14753.78,25
2023-09-28 20:30:00+01:00,7,15,0,8,14702.88,8
2023-09-29 14:30:00+01:00,4,10,0,6,14828.67,6
2023-09-29 15:30:00+01:00,3,14,0,11,14804.04,11
2023-09-29 16:30:00+01:00,2,33,0,31,14792.50,31
2023-09-29 17:30:00+01:00,1,24,0,23,14714.19,23
2023-09-29 18:30:00+01:00,3,10,0,7,14671.34,7
2023-09-29 19:30:00+01:00,4,7,0,3,14725.34,3
2023-09-29 20:30:00+01:00,3,5,0,2,14717.83,2
2023-10-02 14:30:00+01:00,6,13,0,7,14781.23,7
2023-10-02 15:30:00+01:00,6,13,0,7,14887.39,7
2023-10-02 16:30:00+01:00,23,1,22,0,14762.69,-22
2023-10-02 17:30:00+01:00,19,4,15,0,14762.18,-15
2023-10-02 18:30:00+01:00,20,3,17,0,14734.65,-17
2023-10-02 19:30:00+01:00,21,1,20,0,14766.98,-20
2023-10-02 20:30:00+01:00,9,5,4,0,14838.24,-4
2023-10-03 14:30:00+01:00,29,1,28,0,14629.40,-28
2023-10-03 15:30:00+01:00,36,0,36,0,14591.14,-36
2023-10-03 16:30:00+01:00,33,1,32,0,14620.53,-32
2023-10-03 17:30:00+01:00,24,0,24,0,14578.03,-24
2023-10-03 18:30:00+01:00,26,0,26,0,14538.16,-26
2023-10-03 19:30:00+01:00,33,1,32,0,14518.17,-32
2023-10-03 20:30:00+01:00,25,0,25,0,14565.88,-25
2023-10-04 14:30:00+01:00,22,2,20,0,14593.53,-20
2023-10-04 15:30:00+01:00,21,0,21,0,14691.00,-21
2023-10-04 16:30:00+01:00,8,3,5,0,14729.99,-5
2023-10-04 17:30:00+01:00,13,0,13,0,14687.33,-13
2023-10-04 18:30:00+01:00,13,3,10,0,14692.41,-10
2023-10-04 19:30:00+01:00,7,4,3,0,14768.32,-3
2023-10-04 20:30:00+01:00,9,3,6,0,14769.06,-6
2023-10-05 14:30:00+01:00,9,12,0,3,14662.81,3
2023-10-05 15:30:00+01:00,9,10,0,1,14620.70,1
2023-10-05 16:30:00+01:00,7,10,0,3,14682.99,3
2023-10-05 17:30:00+01:00,6,10,0,4,14676.32,4
2023-10-05 18:30:00+01:00,3,24,0,21,14724.72,21
2023-10-05 19:30:00+01:00,3,30,0,27,14741.42,27
2023-10-05 20:30:00+01:00,6,20,0,14,14724.95,14
2023-10-06 14:30:00+01:00,6,24,0,18,14704.80,18
2023-10-06 15:30:00+01:00,5,21,0,16,14789.55,16
2023-10-06 16:30:00+01:00,4,25,0,21,14900.95,21
2023-10-06 17:30:00+01:00,3,41,0,38,14949.51,38
2023-10-06 18:30:00+01:00,3,44,0,41,14986.35,41
2023-10-06 19:30:00+01:00,5,35,0,30,15013.03,30
2023-10-06 20:30:00+01:00,5,28,0,23,14971.34,23
2023-10-09 14:30:00+01:00,3,37,0,34,14894.41,34
2023-10-09 15:30:00+01:00,3,41,0,38,14892.00,38
2023-10-09 16:30:00+01:00,2,38,0,36,14929.70,36
2023-10-09 17:30:00+01:00,1,44,0,43,14963.27,43
2023-10-09 18:30:00+01:00,0,42,0,42,15055.20,42
2023-10-09 19:30:00+01:00,0,40,0,40,15052.45,40
2023-10-09 20:30:00+01:00,0,43,0,43,15047.36,43
2023-10-10 14:30:00+01:00,0,59,0,59,15152.58,59
2023-10-10 15:30:00+01:00,0,51,0,51,15211.86,51
2023-10-10 16:30:00+01:00,0,47,0,47,15228.41,47
2023-10-10 17:30:00+01:00,0,27,0,27,15149.58,27
2023-10-10 18:30:00+01:00,0,21,0,21,15137.56,21
2023-10-10 19:30:00+01:00,0,17,0,17,15149.43,17
2023-10-10 20:30:00+01:00,0,26,0,26,15131.80,26
2023-10-11 14:30:00+01:00,1,43,0,42,15179.09,42
2023-10-11 15:30:00+01:00,0,42,0,42,15178.77,42
2023-10-11 16:30:00+01:00,1,32,0,31,15158.86,31
2023-10-11 17:30:00+01:00,3,25,0,22,15146.80,22
2023-10-11 18:30:00+01:00,4,20,0,16,15172.93,16
2023-10-11 19:30:00+01:00,2,25,0,23,15204.96,23
2023-10-11 20:30:00+01:00,1,31,0,30,15240.28,30
2023-10-12 14:30:00+01:00,21,21,0,0,15289.73,0
2023-10-12 15:30:00+01:00,25,17,8,0,15291.78,-8
2023-10-12 16:30:00+01:00,20,19,1,0,15330.90,-1
2023-10-12 17:30:00+01:00,23,7,16,0,15181.27,-16
2023-10-12 18:30:00+01:00,25,7,18,0,15139.08,-18
2023-10-12 19:30:00+01:00,26,8,18,0,15173.05,-18
2023-10-12 20:30:00+01:00,23,8,15,0,15183.82,-15
2023-10-13 14:30:00+01:00,25,8,17,0,15150.49,-17
2023-10-13 15:30:00+01:00,33,4,29,0,15035.22,-29
2023-10-13 16:30:00+01:00,30,6,24,0,15056.92,-24
2023-10-13 17:30:00+01:00,34,3,31,0,14957.30,-31
2023-10-13 18:30:00+01:00,30,1,29,0,14987.38,-29
2023-10-13 19:30:00+01:00,35,1,34,0,14984.11,-34
2023-10-13 20:30:00+01:00,34,1,33,0,14997.51,-33
2023-10-16 14:30:00+01:00,11,3,8,0,15173.10,-8
2023-10-16 15:30:00+01:00,8,4,4,0,15173.75,-4
2023-10-16 16:30:00+01:00,13,4,9,0,15157.59,-9
2023-10-16 17:30:00+01:00,8,14,0,6,15138.77,6
2023-10-16 18:30:00+01:00,6,19,0,13,15180.97,13
2023-10-16 19:30:00+01:00,6,19,0,13,15207.55,13
2023-10-16 20:30:00+01:00,6,16,0,10,15166.04,10
2023-10-17 14:30:00+01:00,8,15,0,7,15060.10,7
2023-10-17 15:30:00+01:00,3,25,0,22,15116.27,22
2023-10-17 16:30:00+01:00,4,29,0,25,15184.86,25
2023-10-17 17:30:00+01:00,3,39,0,36,15139.73,36
2023-10-17 18:30:00+01:00,3,25,0,22,15099.17,22
2023-10-17 19:30:00+01:00,3,24,0,21,15095.15,21
2023-10-17 20:30:00+01:00,3,21,0,18,15120.71,18
2023-10-18 14:30:00+01:00,12,7,5,0,15042.73,-5
2023-10-18 15:30:00+01:00,13,5,8,0,15013.04,-8
2023-10-18 16:30:00+01:00,18,5,13,0,14998.46,-13
2023-10-18 17:30:00+01:00,14,5,9,0,15026.35,-9
2023-10-18 18:30:00+01:00,20,6,14,0,14981.32,-14
2023-10-18 19:30:00+01:00,34,3,31,0,14910.18,-31
2023-10-18 20:30:00+01:00,29,3,26,0,14904.52,-26
2023-10-19 14:30:00+01:00,33,1,32,0,14907.36,-32
2023-10-19 15:30:00+01:00,37,3,34,0,14904.90,-34
2023-10-19 16:30:00+01:00,44,2,42,0,14929.22,-42
2023-10-19 17:30:00+01:00,31,4,27,0,14953.18,-27
2023-10-19 18:30:00+01:00,38,2,36,0,14881.53,-36
2023-10-19 19:30:00+01:00,48,2,46,0,14778.77,-46
2023-10-19 20:30:00+01:00,50,2,48,0,14780.54,-48
2023-10-20 14:30:00+01:00,56,1,55,0,14662.31,-55
2023-10-20 15:30:00+01:00,57,2,55,0,14576.63,-55
2023-10-20 16:30:00+01:00,49,2,47,0,14607.72,-47
2023-10-20 17:30:00+01:00,43,1,42,0,14673.43,-42
2023-10-20 18:30:00+01:00,48,1,47,0,14610.21,-47
2023-10-20 19:30:00+01:00,42,1,41,0,14596.48,-41
2023-10-20 20:30:00+01:00,43,1,42,0,14560.29,-42
2023-10-23 14:30:00+01:00,42,0,42,0,14568.04,-42
2023-10-23 15:30:00+01:00,31,0,31,0,14641.62,-31
2023-10-23 16:30:00+01:00,26,0,26,0,14682.13,-26
2023-10-23 17:30:00+01:00,43,0,43,0,14693.78,-43
2023-10-23 18:30:00+01:00,31,0,31,0,14682.18,-31
2023-10-23 19:30:00+01:00,23,0,23,0,14636.42,-23
2023-10-23 20:30:00+01:00,29,0,29,0,14607.93,-29
2023-10-24 14:30:00+01:00,4,8,0,4,14742.55,4
2023-10-24 15:30:00+01:00,5,16,0,11,14705.34,11
2023-10-24 16:30:00+01:00,9,10,0,1,14646.84,1
2023-10-24 17:30:00+01:00,15,8,7,0,14672.53,-7
2023-10-24 18:30:00+01:00,8,14,0,6,14706.44,6
2023-10-24 19:30:00+01:00,6,19,0,13,14752.70,13
2023-10-24 20:30:00+01:00,7,23,0,16,14745.60,16
2023-10-25 14:30:00+01:00,13,7,6,0,14519.94,-6
2023-10-25 15:30:00+01:00,8,6,2,0,14549.54,-2
2023-10-25 16:30:00+01:00,16,5,11,0,14485.27,-11
2023-10-25 17:30:00+01:00,24,3,21,0,14414.62,-21
2023-10-25 18:30:00+01:00,21,2,19,0,14394.57,-19
2023-10-25 19:30:00+01:00,17,6,11,0,14393.77,-11
2023-10-25 20:30:00+01:00,15,8,7,0,14386.12,-7
2023-10-26 14:30:00+01:00,42,4,38,0,14233.56,-38
2023-10-26 15:30:00+01:00,40,2,38,0,14173.49,-38
2023-10-26 16:30:00+01:00,44,2,42,0,14107.35,-42
2023-10-26 17:30:00+01:00,48,2,46,0,14075.89,-46
2023-10-26 18:30:00+01:00,40,1,39,0,14169.89,-39
2023-10-26 19:30:00+01:00,48,1,47,0,14182.11,-47
2023-10-26 20:30:00+01:00,52,1,51,0,14109.64,-51
2023-10-27 14:30:00+01:00,29,3,26,0,14244.80,-26
2023-10-27 15:30:00+01:00,26,3,23,0,14304.89,-23
2023-10-27 16:30:00+01:00,22,4,18,0,14252.27,-18
2023-10-27 17:30:00+01:00,25,3,22,0,14175.25,-22
2023-10-27 18:30:00+01:00,27,4,23,0,14142.39,-23
2023-10-27 19:30:00+01:00,27,3,24,0,14175.04,-24
2023-10-27 20:30:00+01:00,24,3,21,0,14183.08,-21
2023-10-30 13:30:00+00:00,22,5,17,0,14257.00,-17
2023-10-30 14:30:00+00:00,23,5,18,0,14255.66,-18
2023-10-30 15:30:00+00:00,18,9,9,0,14263.96,-9
2023-10-30 16:30:00+00:00,9,8,1,0,14311.64,-1
2023-10-30 17:30:00+00:00,15,9,6,0,14323.52,-6
2023-10-30 18:30:00+00:00,7,7,0,0,14365.19,0
2023-10-30 19:30:00+00:00,8,11,0,3,14333.27,3
2023-10-31 13:30:00+00:00,5,11,0,6,14316.63,6
2023-10-31 14:30:00+00:00,7,9,0,2,14300.59,2
2023-10-31 15:30:00+00:00,5,13,0,8,14314.70,8
2023-10-31 16:30:00+00:00,3,31,0,28,14350.27,28
2023-10-31 17:30:00+00:00,3,41,0,38,14365.14,38
2023-10-31 18:30:00+00:00,2,40,0,38,14404.97,38
2023-10-31 19:30:00+00:00,1,39,0,38,14410.08,38
2023-11-01 13:30:00+00:00,2,45,0,43,14548.40,43
2023-11-01 14:30:00+00:00,6,25,0,19,14509.16,19
2023-11-01 15:30:00+00:00,4,27,0,23,14512.90,23
2023-11-01 16:30:00+00:00,5,23,0,18,14515.19,18
2023-11-01 17:30:00+00:00,5,20,0,15,14533.06,15
2023-11-01 18:30:00+00:00,3,26,0,23,14647.23,23
2023-11-01 19:30:00+00:00,2,35,0,33,14663.17,33
2023-11-02 13:30:00+00:00,3,52,0,49,14850.04,49
2023-11-02 14:30:00+00:00,4,56,0,52,14863.96,52
2023-11-02 15:30:00+00:00,3,51,0,48,14862.75,48
2023-11-02 16:30:00+00:00,1,53,0,52,14893.01,52
2023-11-02 17:30:00+00:00,3,54,0,51,14915.56,51
2023-11-02 18:30:00+00:00,2,51,0,49,14914.83,49
2023-11-02 19:30:00+00:00,2,50,0,48,14921.79,48
2023-11-03 13:30:00+00:00,3,64,0,61,14994.83,61
2023-11-03 14:30:00+00:00,1,68,0,67,15028.38,67
2023-11-03 15:30:00+00:00,1,74,0,73,15105.55,73
2023-11-03 16:30:00+00:00,1,70,0,69,15089.18,69
2023-11-03 17:30:00+00:00,1,70,0,69,15126.06,69
2023-11-03 18:30:00+00:00,1,59,0,58,15118.35,58
2023-11-03 19:30:00+00:00,1,60,0,59,15099.63,59
2023-11-06 14:30:00+00:00,4,35,0,31,15135.29,31
2023-11-06 15:30:00+00:00,2,33,0,31,15146.30,31
2023-11-06 16:30:00+00:00,2,30,0,28,15127.04,28
2023-11-06 17:30:00+00:00,4,21,0,17,15078.07,17
2023-11-06 18:30:00+00:00,5,24,0,19,15096.28,19
2023-11-06 19:30:00+00:00,4,28,0,24,15129.26,24
2023-11-06 20:30:00+00:00,3,31,0,28,15156.99,28
2023-11-07 14:30:00+00:00,5,22,0,17,15261.30,17
2023-11-07 15:30:00+00:00,6,23,0,17,15311.22,17
2023-11-07 16:30:00+00:00,11,11,0,0,15273.19,0
2023-11-07 17:30:00+00:00,10,16,0,6,15316.18,6
2023-11-07 18:30:00+00:00,12,13,0,1,15327.61,1
2023-11-07 19:30:00+00:00,12,17,0,5,15321.83,5
2023-11-07 20:30:00+00:00,9,16,0,7,15297.22,7
2023-11-08 14:30:00+00:00,13,25,0,12,15275.18,12
2023-11-08 15:30:00+00:00,13,25,0,12,15276.20,12
2023-11-08 16:30:00+00:00,17,17,0,0,15242.02,0
2023-11-08 17:30:00+00:00,12,31,0,19,15283.39,19
2023-11-08 18:30:00+00:00,12,32,0,20,15309.33,20
2023-11-08 19:30:00+00:00,11,25,0,14,15297.30,14
2023-11-08 20:30:00+00:00,9,22,0,13,15313.54,13
2023-11-09 14:30:00+00:00,18,17,1,0,15293.65,-1
2023-11-09 15:30:00+00:00,18,19,0,1,15340.33,1
2023-11-09 16:30:00+00:00,17,19,0,2,15327.13,2
2023-11-09 17:30:00+00:00,19,13,6,0,15311.79,-6
2023-11-09 18:30:00+00:00,25,4,21,0,15247.11,-21
2023-11-09 19:30:00+00:00,31,2,29,0,15188.70,-29
2023-11-09 20:30:00+00:00,32,2,30,0,15187.58,-30
2023-11-10 14:30:00+00:00,22,6,16,0,15264.80,-16
2023-11-10 15:30:00+00:00,11,8,3,0,15366.84,-3
2023-11-10 16:30:00+00:00,8,21,0,13,15408.45,13
2023-11-10 17:30:00+00:00,7,22,0,15,15467.39,15
2023-11-10 18:30:00+00:00,4,24,0,20,15502.51,20
2023-11-10 19:30:00+00:00,4,28,0,24,15521.71,24
2023-11-10 20:30:00+00:00,4,24,0,20,15530.11,20
2023-11-13 14:30:00+00:00,2,14,0,12,15457.33,12
2023-11-13 15:30:00+00:00,5,12,0,7,15503.31,7
2023-11-13 16:30:00+00:00,2,19,0,17,15490.93,17
2023-11-13 17:30:00+00:00,4,19,0,15,15482.43,15
2023-11-13 18:30:00+00:00,3,35,0,32,15519.56,32
2023-11-13 19:30:00+00:00,3,47,0,44,15508.74,44
2023-11-13 20:30:00+00:00,3,47,0,44,15483.20,44
2023-11-14 14:30:00+00:00,1,73,0,72,15812.72,72
2023-11-14 15:30:00+00:00,2,63,0,61,15801.76,61
2023-11-14 16:30:00+00:00,1,52,0,51,15773.30,51
2023-11-14 17:30:00+00:00,2,45,0,43,15811.44,43
2023-11-14 18:30:00+00:00,3,37,0,34,15787.51,34
2023-11-14 19:30:00+00:00,2,42,0,40,15842.25,40
2023-11-14 20:30:00+00:00,2,37,0,35,15811.12,35
2023-11-15 14:30:00+00:00,3,63,0,60,15866.72,60
2023-11-15 15:30:00+00:00,3,59,0,56,15888.08,56
2023-11-15 16:30:00+00:00,3,51,0,48,15836.64,48
2023-11-15 17:30:00+00:00,3,49,0,46,15815.32,46
2023-11-15 18:30:00+00:00,4,52,0,48,15848.44,48
2023-11-15 19:30:00+00:00,4,49,0,45,15826.57,45
2023-11-15 20:30:00+00:00,4,50,0,46,15820.98,46
2023-11-16 14:30:00+00:00,8,5,3,0,15815.75,-3
2023-11-16 15:30:00+00:00,9,6,3,0,15750.48,-3
2023-11-16 16:30:00+00:00,6,10,0,4,15811.78,4
2023-11-16 17:30:00+00:00,8,11,0,3,15805.35,3
2023-11-16 18:30:00+00:00,7,11,0,4,15791.70,4
2023-11-16 19:30:00+00:00,7,10,0,3,15811.52,3
2023-11-16 20:30:00+00:00,5,9,0,4,15834.07,4
2023-11-17 14:30:00+00:00,18,4,14,0,15809.57,-14
2023-11-17 15:30:00+00:00,20,4,16,0,15797.17,-16
2023-11-17 16:30:00+00:00,14,6,8,0,15808.91,-8
2023-11-17 17:30:00+00:00,9,8,1,0,15846.46,-1
2023-11-17 18:30:00+00:00,13,6,7,0,15857.17,-7
2023-11-17 19:30:00+00:00,10,8,2,0,15849.59,-2
2023-11-17 20:30:00+00:00,9,8,1,0,15837.71,-1
2023-11-20 14:30:00+00:00,6,17,0,11,15902.93,11
2023-11-20 15:30:00+00:00,4,39,0,35,15950.28,35
2023-11-20 16:30:00+00:00,5,30,0,25,15961.08,25
2023-11-20 17:30:00+00:00,3,40,0,37,16011.48,37
2023-11-20 18:30:00+00:00,5,44,0,39,16013.28,39
2023-11-20 19:30:00+00:00,1,47,0,46,16047.49,46
2023-11-20 20:30:00+00:00,2,38,0,36,16030.26,36
2023-11-21 14:30:00+00:00,7,15,0,8,15875.82,8
2023-11-21 15:30:00+00:00,3,23,0,20,15893.88,20
2023-11-21 16:30:00+00:00,5,23,0,18,15919.77,18
2023-11-21 17:30:00+00:00,6,21,0,15,15901.92,15
2023-11-21 18:30:00+00:00,3,20,0,17,15921.22,17
2023-11-21 19:30:00+00:00,5,21,0,16,15937.79,16
2023-11-21 20:30:00+00:00,3,19,0,16,15936.46,16
2023-11-22 14:30:00+00:00,1,28,0,27,16013.49,27
2023-11-22 15:30:00+00:00,3,25,0,22,16014.95,22
2023-11-22 16:30:00+00:00,3,26,0,23,16042.40,23
2023-11-22 17:30:00+00:00,2,20,0,18,16053.08,18
2023-11-22 18:30:00+00:00,1,20,0,19,16039.52,19
2023-11-22 19:30:00+00:00,10,10,0,0,16009.41,0
2023-11-22 20:30:00+00:00,7,12,0,5,16001.37,5
2023-11-24 14:30:00+00:00,2,24,0,22,15951.72,22
2023-11-24 15:30:00+00:00,2,23,0,21,15962.07,21
2023-11-24 16:30:00+00:00,7,22,0,15,15971.55,15
2023-11-27 14:30:00+00:00,2,16,0,14,15975.89,14
2023-11-27 15:30:00+00:00,2,19,0,17,15984.77,17
2023-11-27 16:30:00+00:00,0,19,0,19,16018.32,19
2023-11-27 17:30:00+00:00,3,22,0,19,16025.14,19
2023-11-27 18:30:00+00:00,10,6,4,0,15997.18,-4
2023-11-27 19:30:00+00:00,9,6,3,0,15994.35,-3
2023-11-27 20:30:00+00:00,13,4,9,0,15963.30,-9
2023-11-28 14:30:00+00:00,20,6,14,0,15947.21,-14
2023-11-28 15:30:00+00:00,10,10,0,0,16000.73,0
2023-11-28 16:30:00+00:00,9,11,0,2,16002.98,2
2023-11-28 17:30:00+00:00,13,10,3,0,15962.41,-3
2023-11-28 18:30:00+00:00,17,9,8,0,15958.62,-8
2023-11-28 19:30:00+00:00,17,9,8,0,15964.75,-8
2023-11-28 20:30:00+00:00,14,9,5,0,16008.32,-5
2023-11-29 14:30:00+00:00,12,21,0,9,16070.79,9
2023-11-29 15:30:00+00:00,17,14,3,0,16006.20,-3
2023-11-29 16:30:00+00:00,10,15,0,5,16051.20,5
2023-11-29 17:30:00+00:00,11,15,0,4,16048.32,4
2023-11-29 18:30:00+00:00,13,14,0,1,16031.36,1
2023-11-29 19:30:00+00:00,15,11,4,0,15985.90,-4
2023-11-29 20:30:00+00:00,13,13,0,0,15988.12,0
2023-11-30 14:30:00+00:00,17,17,0,0,15915.51,0
2023-11-30 15:30:00+00:00,21,13,8,0,15861.91,-8
2023-11-30 16:30:00+00:00,24,12,12,0,15844.83,-12
2023-11-30 17:30:00+00:00,19,13,6,0,15836.90,-6
2023-11-30 18:30:00+00:00,17,13,4,0,15854.47,-4
2023-11-30 19:30:00+00:00,16,12,4,0,15851.21,-4
2023-11-30 20:30:00+00:00,6,14,0,8,15950.14,8
2023-12-01 14:30:00+00:00,21,6,15,0,15848.64,-15
2023-12-01 15:30:00+00:00,9,12,0,3,15929.68,3
2023-12-01 16:30:00+00:00,9,12,0,3,15984.78,3
2023-12-01 17:30:00+00:00,10,14,0,4,15976.95,4
2023-12-01 18:30:00+00:00,7,12,0,5,15984.26,5
2023-12-01 19:30:00+00:00,5,25,0,20,15997.97,20
2023-12-01 20:30:00+00:00,5,30,0,25,15993.78,25
2023-12-04 14:30:00+00:00,13,21,0,8,15727.25,8
2023-12-04 15:30:00+00:00,9,21,0,12,15740.52,12
2023-12-04 16:30:00+00:00,3,29,0,26,15808.77,26
2023-12-04 17:30:00+00:00,4,26,0,22,15792.95,22
2023-12-04 18:30:00+00:00,5,23,0,18,15798.28,18
2023-12-04 19:30:00+00:00,6,22,0,16,15803.31,16
2023-12-04 20:30:00+00:00,6,20,0,14,15838.37,14
2023-12-05 14:30:00+00:00,3,8,0,5,15862.15,5
2023-12-05 15:30:00+00:00,15,8,7,0,15852.62,-7
2023-12-05 16:30:00+00:00,22,6,16,0,15859.14,-16
2023-12-05 17:30:00+00:00,24,6,18,0,15847.95,-18
2023-12-05 18:30:00+00:00,19,5,14,0,15865.37,-14
2023-12-05 19:30:00+00:00,20,5,15,0,15868.87,-15
2023-12-05 20:30:00+00:00,18,3,15,0,15879.07,-15
2023-12-06 14:30:00+00:00,8,19,0,11,15870.39,11
2023-12-06 15:30:00+00:00,9,20,0,11,15886.26,11
2023-12-06 16:30:00+00:00,8,13,0,5,15871.57,5
2023-12-06 17:30:00+00:00,7,13,0,6,15853.88,6
2023-12-06 18:30:00+00:00,9,10,0,1,15839.52,1
2023-12-06 19:30:00+00:00,10,6,4,0,15802.35,-4
2023-12-06 20:30:00+00:00,15,4,11,0,15791.10,-11
2023-12-07 14:30:00+00:00,5,21,0,16,15973.19,16
2023-12-07 15:30:00+00:00,8,17,0,9,15949.03,9
2023-12-07 16:30:00+00:00,5,19,0,14,16026.69,14
2023-12-07 17:30:00+00:00,5,22,0,17,16004.52,17
2023-12-07 18:30:00+00:00,4,27,0,23,16036.81,23
2023-12-07 19:30:00+00:00,5,24,0,19,16019.19,19
2023-12-07 20:30:00+00:00,11,20,0,9,16021.67,9
2023-12-08 14:30:00+00:00,6,17,0,11,16083.90,11
2023-12-08 15:30:00+00:00,11,7,4,0,16034.22,-4
2023-12-08 16:30:00+00:00,10,9,1,0,16040.13,-1
2023-12-08 17:30:00+00:00,9,16,0,7,16061.54,7
2023-12-08 18:30:00+00:00,6,23,0,17,16082.64,17
2023-12-08 19:30:00+00:00,7,32,0,25,16093.39,25
2023-12-08 20:30:00+00:00,7,28,0,21,16082.68,21
2023-12-11 14:30:00+00:00,9,40,0,31,16132.29,31
2023-12-11 15:30:00+00:00,5,42,0,37,16138.68,37
2023-12-11 16:30:00+00:00,4,40,0,36,16174.13,36
2023-12-11 17:30:00+00:00,3,38,0,35,16209.23,35
2023-12-11 18:30:00+00:00,4,39,0,35,16221.32,35
2023-12-11 19:30:00+00:00,4,37,0,33,16202.92,33
2023-12-11 20:30:00+00:00,3,38,0,35,16223.24,35
2023-12-12 14:30:00+00:00,8,40,0,32,16246.88,32
2023-12-12 15:30:00+00:00,7,53,0,46,16274.34,46
2023-12-12 16:30:00+00:00,8,52,0,44,16267.10,44
2023-12-12 17:30:00+00:00,9,52,0,43,16281.70,43
2023-12-12 18:30:00+00:00,5,53,0,48,16308.59,48
2023-12-12 19:30:00+00:00,6,52,0,46,16339.40,46
2023-12-12 20:30:00+00:00,7,58,0,51,16353.87,51
2023-12-13 14:30:00+00:00,6,36,0,30,16405.98,30
2023-12-13 15:30:00+00:00,9,34,0,25,16388.06,25
2023-12-13 16:30:00+00:00,11,36,0,25,16385.30,25
2023-12-13 17:30:00+00:00,15,29,0,14,16361.26,14
2023-12-13 18:30:00+00:00,5,40,0,35,16476.77,35
2023-12-13 19:30:00+00:00,1,48,0,47,16497.74,47
2023-12-13 20:30:00+00:00,1,53,0,52,16560.23,52
2023-12-14 14:30:00+00:00,3,45,0,42,16576.34,42
2023-12-14 15:30:00+00:00,4,45,0,41,16554.52,41
2023-12-14 16:30:00+00:00,4,48,0,44,16598.40,44
2023-12-14 17:30:00+00:00,4,31,0,27,16473.61,27
2023-12-14 18:30:00+00:00,3,26,0,23,16509.67,23
2023-12-14 19:30:00+00:00,6,28,0,22,16518.52,22
2023-12-14 20:30:00+00:00,6,31,0,25,16539.93,25
2023-12-15 14:30:00+00:00,8,32,0,24,16651.95,24
2023-12-15 15:30:00+00:00,8,34,0,26,16657.66,26
2023-12-15 16:30:00+00:00,7,31,0,24,16647.98,24
2023-12-15 17:30:00+00:00,7,32,0,25,16621.09,25
2023-12-15 18:30:00+00:00,12,22,0,10,16580.87,10
2023-12-15 19:30:00+00:00,15,20,0,5,16618.41,5
2023-12-15 20:30:00+00:00,17,17,0,0,16607.11,0
2023-12-18 14:30:00+00:00,15,8,7,0,16695.17,-7
2023-12-18 15:30:00+00:00,12,9,3,0,16691.39,-3
2023-12-18 16:30:00+00:00,13,8,5,0,16718.41,-5
2023-12-18 17:30:00+00:00,10,17,0,7,16738.54,7
2023-12-18 18:30:00+00:00,10,15,0,5,16746.30,5
2023-12-18 19:30:00+00:00,10,19,0,9,16761.64,9
2023-12-18 20:30:00+00:00,11,14,0,3,16730.51,3
2023-12-19 14:30:00+00:00,7,18,0,11,16781.21,11
2023-12-19 15:30:00+00:00,11,19,0,8,16787.71,8
2023-12-19 16:30:00+00:00,7,16,0,9,16773.69,9
2023-12-19 17:30:00+00:00,5,17,0,12,16778.68,12
2023-12-19 18:30:00+00:00,3,23,0,20,16793.95,20
2023-12-19 19:30:00+00:00,3,23,0,20,16785.28,20
2023-12-19 20:30:00+00:00,1,24,0,23,16811.90,23
2023-12-20 14:30:00+00:00,4,28,0,24,16840.01,24
2023-12-20 15:30:00+00:00,6,27,0,21,16830.90,21
2023-12-20 16:30:00+00:00,7,27,0,20,16832.10,20
2023-12-20 17:30:00+00:00,5,20,0,15,16847.17,15
2023-12-20 18:30:00+00:00,7,18,0,11,16799.96,11
2023-12-20 19:30:00+00:00,22,3,19,0,16587.65,-19
2023-12-20 20:30:00+00:00,26,1,25,0,16555.19,-25
2023-12-21 14:30:00+00:00,9,2,7,0,16679.68,-7
2023-12-21 15:30:00+00:00,9,3,6,0,16696.53,-6
2023-12-21 16:30:00+00:00,10,1,9,0,16640.42,-9
2023-12-21 17:30:00+00:00,10,2,8,0,16664.98,-8
2023-12-21 18:30:00+00:00,10,2,8,0,16680.85,-8
2023-12-21 19:30:00+00:00,7,2,5,0,16738.16,-5
2023-12-21 20:30:00+00:00,8,2,6,0,16757.54,-6
2023-12-22 14:30:00+00:00,8,7,1,0,16826.51,-1
2023-12-22 15:30:00+00:00,8,5,3,0,16800.69,-3
2023-12-22 16:30:00+00:00,8,6,2,0,16791.29,-2
2023-12-22 17:30:00+00:00,8,7,1,0,16816.46,-1
2023-12-22 18:30:00+00:00,10,3,7,0,16719.27,-7
2023-12-22 19:30:00+00:00,3,32,0,29,16789.73,29
2023-12-22 20:30:00+00:00,3,38,0,35,16780.56,35
2023-12-26 14:30:00+00:00,2,19,0,17,16844.85,17
2023-12-26 15:30:00+00:00,3,17,0,14,16837.12,14
2023-12-26 16:30:00+00:00,3,37,0,34,16846.15,34
2023-12-26 17:30:00+00:00,3,37,0,34,16858.66,34
2023-12-26 18:30:00+00:00,2,35,0,33,16860.77,33
2023-12-26 19:30:00+00:00,3,35,0,32,16898.42,32
2023-12-26 20:30:00+00:00,4,22,0,18,16879.10,18
2023-12-27 14:30:00+00:00,5,10,0,5,16883.20,5
2023-12-27 15:30:00+00:00,6,12,0,6,16877.46,6
2023-12-27 16:30:00+00:00,5,14,0,9,16890.06,9
2023-12-27 17:30:00+00:00,5,14,0,9,16907.97,9
2023-12-27 18:30:00+00:00,3,37,0,34,16895.70,34
2023-12-27 19:30:00+00:00,5,24,0,19,16884.90,19
2023-12-27 20:30:00+00:00,2,31,0,29,16910.32,29
2023-12-28 14:30:00+00:00,9,27,0,18,16940.46,18
2023-12-28 15:30:00+00:00,9,27,0,18,16926.68,18
2023-12-28 16:30:00+00:00,5,20,0,15,16931.56,15
2023-12-28 17:30:00+00:00,5,19,0,14,16929.45,14
2023-12-28 18:30:00+00:00,4,17,0,13,16937.42,13
2023-12-28 19:30:00+00:00,15,10,5,0,16912.14,-5
2023-12-28 20:30:00+00:00,12,11,1,0,16902.33,-1
2023-12-29 14:30:00+00:00,14,18,0,4,16905.16,4
2023-12-29 15:30:00+00:00,31,8,23,0,16758.27,-23
2023-12-29 16:30:00+00:00,25,4,21,0,16765.34,-21
2023-12-29 17:30:00+00:00,15,4,11,0,16813.76,-11
2023-12-29 18:30:00+00:00,12,6,6,0,16831.34,-6
2023-12-29 19:30:00+00:00,9,8,1,0,16848.46,-1
2023-12-29 20:30:00+00:00,16,4,12,0,16828.09,-12
2024-01-02 14:30:00+00:00,51,13,38,0,16551.90,-38
2024-01-02 15:30:00+00:00,45,10,35,0,16584.28,-35
2024-01-02 16:30:00+00:00,47,14,33,0,16585.50,-33
2024-01-02 17:30:00+00:00,50,12,38,0,16559.23,-38
2024-01-02 18:30:00+00:00,53,11,42,0,16526.54,-42
2024-01-02 19:30:00+00:00,54,10,44,0,16471.23,-44
2024-01-02 20:30:00+00:00,41,13,28,0,16545.28,-28
2024-01-03 14:30:00+00:00,57,9,48,0,16412.85,-48
2024-01-03 15:30:00+00:00,48,10,38,0,16417.82,-38
2024-01-03 16:30:00+00:00,48,11,37,0,16404.17,-37
2024-01-03 17:30:00+00:00,53,11,42,0,16418.13,-42
2024-01-03 18:30:00+00:00,49,12,37,0,16444.43,-37
2024-01-03 19:30:00+00:00,56,7,49,0,16386.33,-49
2024-01-03 20:30:00+00:00,56,7,49,0,16367.35,-49
2024-01-04 14:30:00+00:00,35,8,27,0,16347.30,-27
2024-01-04 15:30:00+00:00,30,7,23,0,16405.19,-23
2024-01-04 16:30:00+00:00,34,4,30,0,16362.97,-30
2024-01-04 17:30:00+00:00,31,4,27,0,16355.61,-27
2024-01-04 18:30:00+00:00,30,4,26,0,16321.34,-26
2024-01-04 19:30:00+00:00,20,7,13,0,16325.71,-13
2024-01-04 20:30:00+00:00,34,2,32,0,16285.39,-32
2024-01-05 14:30:00+00:00,15,11,4,0,16380.96,-4
2024-01-05 15:30:00+00:00,21,12,9,0,16365.26,-9
2024-01-05 16:30:00+00:00,22,8,14,0,16300.03,-14
2024-01-05 17:30:00+00:00,27,9,18,0,16311.99,-18
2024-01-05 18:30:00+00:00,28,7,21,0,16321.27,-21
2024-01-05 19:30:00+00:00,27,5,22,0,16262.57,-22
2024-01-05 20:30:00+00:00,19,6,13,0,16303.34,-13
2024-01-08 14:30:00+00:00,15,16,0,1,16481.57,1
2024-01-08 15:30:00+00:00,17,14,3,0,16490.86,-3
2024-01-08 16:30:00+00:00,10,13,0,3,16525.95,3
2024-01-08 17:30:00+00:00,10,19,0,9,16555.63,9
2024-01-08 18:30:00+00:00,6,27,0,21,16597.15,21
2024-01-08 19:30:00+00:00,5,20,0,15,16620.91,15
2024-01-08 20:30:00+00:00,2,44,0,42,16645.59,42
2024-01-09 14:30:00+00:00,5,26,0,21,16573.24,21
2024-01-09 15:30:00+00:00,3,28,0,25,16627.14,25
2024-01-09 16:30:00+00:00,2,45,0,43,16673.46,43
2024-01-09 17:30:00+00:00,3,40,0,37,16676.84,37
2024-01-09 18:30:00+00:00,2,34,0,32,16661.52,32
2024-01-09 19:30:00+00:00,2,47,0,45,16669.57,45
2024-01-09 20:30:00+00:00,2,45,0,43,16676.63,43
2024-01-10 14:30:00+00:00,1,25,0,24,16708.48,24
2024-01-10 15:30:00+00:00,4,24,0,20,16716.49,20
2024-01-10 16:30:00+00:00,9,26,0,17,16736.94,17
2024-01-10 17:30:00+00:00,8,23,0,15,16753.31,15
2024-01-10 18:30:00+00:00,6,23,0,17,16798.56,17
2024-01-10 19:30:00+00:00,7,22,0,15,16786.51,15
2024-01-10 20:30:00+00:00,10,21,0,11,16792.17,11
2024-01-11 14:30:00+00:00,12,22,0,10,16749.36,10
2024-01-11 15:30:00+00:00,19,9,10,0,16655.40,-10
2024-01-11 16:30:00+00:00,21,6,15,0,16647.61,-15
2024-01-11 17:30:00+00:00,10,11,0,1,16745.92,1
2024-01-11 18:30:00+00:00,6,17,0,11,16802.45,11
2024-01-11 19:30:00+00:00,7,15,0,8,16803.09,8
2024-01-11 20:30:00+00:00,8,16,0,8,16818.81,8
2024-01-12 14:30:00+00:00,7,16,0,9,16823.39,9
2024-01-12 15:30:00+00:00,5,18,0,13,16843.08,13
2024-01-12 16:30:00+00:00,8,16,0,8,16803.73,8
2024-01-12 17:30:00+00:00,8,15,0,7,16830.26,7
2024-01-12 18:30:00+00:00,15,13,2,0,16833.06,-2
2024-01-12 19:30:00+00:00,13,13,0,0,16813.63,0
2024-01-12 20:30:00+00:00,16,15,1,0,16829.48,-1
2024-01-16 14:30:00+00:00,13,18,0,5,16860.60,5
2024-01-16 15:30:00+00:00,14,26,0,12,16861.93,12
2024-01-16 16:30:00+00:00,16,21,0,5,16784.75,5
2024-01-16 17:30:00+00:00,20,16,4,0,16798.79,-4
2024-01-16 18:30:00+00:00,30,7,23,0,16757.03,-23
2024-01-16 19:30:00+00:00,22,6,16,0,16791.50,-16
2024-01-16 20:30:00+00:00,20,11,9,0,16829.46,-9
2024-01-17 14:30:00+00:00,38,3,35,0,16622.24,-35
2024-01-17 15:30:00+00:00,37,2,35,0,16689.88,-35
2024-01-17 16:30:00+00:00,36,3,33,0,16659.47,-33
2024-01-17 17:30:00+00:00,39,3,36,0,16638.47,-36
2024-01-17 18:30:00+00:00,34,4,30,0,16669.57,-30
2024-01-17 19:30:00+00:00,33,3,30,0,16670.42,-30
2024-01-17 20:30:00+00:00,22,6,16,0,16737.75,-16
2024-01-18 14:30:00+00:00,7,4,3,0,16904.06,-3
2024-01-18 15:30:00+00:00,6,6,0,0,16956.80,0
2024-01-18 16:30:00+00:00,6,6,0,0,16894.97,0
2024-01-18 17:30:00+00:00,9,3,6,0,16830.85,-6
2024-01-18 18:30:00+00:00,6,11,0,5,16963.91,5
2024-01-18 19:30:00+00:00,3,12,0,9,16978.92,9
2024-01-18 20:30:00+00:00,3,8,0,5,16981.38,5
2024-01-19 14:30:00+00:00,3,48,0,45,17089.60,45
2024-01-19 15:30:00+00:00,3,39,0,36,17128.44,36
2024-01-19 16:30:00+00:00,2,49,0,47,17156.75,47
2024-01-19 17:30:00+00:00,1,59,0,58,17220.09,58
2024-01-19 18:30:00+00:00,1,64,0,63,17280.31,63
2024-01-19 19:30:00+00:00,1,61,0,60,17298.47,60
2024-01-19 20:30:00+00:00,1,54,0,53,17310.66,53
2024-01-22 14:30:00+00:00,2,57,0,55,17356.61,55
2024-01-22 15:30:00+00:00,2,51,0,49,17364.25,49
2024-01-22 16:30:00+00:00,3,54,0,51,17363.24,51
2024-01-22 17:30:00+00:00,2,49,0,47,17311.37,47
2024-01-22 18:30:00+00:00,3,47,0,44,17333.59,44
2024-01-22 19:30:00+00:00,2,45,0,43,17358.70,43
2024-01-22 20:30:00+00:00,3,38,0,35,17329.18,35
2024-01-23 14:30:00+00:00,2,36,0,34,17338.02,34
2024-01-23 15:30:00+00:00,2,23,0,21,17317.90,21
2024-01-23 16:30:00+00:00,3,22,0,19,17326.12,19
2024-01-23 17:30:00+00:00,4,16,0,12,17351.58,12
2024-01-23 18:30:00+00:00,6,13,0,7,17347.57,7
2024-01-23 19:30:00+00:00,5,17,0,12,17384.23,12
2024-01-23 20:30:00+00:00,6,20,0,14,17401.93,14
2024-01-24 14:30:00+00:00,9,22,0,13,17590.79,13
2024-01-24 15:30:00+00:00,6,23,0,17,17583.99,17
2024-01-24 16:30:00+00:00,8,24,0,16,17637.84,16
2024-01-24 17:30:00+00:00,5,27,0,22,17632.31,22
2024-01-24 18:30:00+00:00,5,11,0,6,17522.87,6
2024-01-24 19:30:00+00:00,6,11,0,5,17492.83,5
2024-01-24 20:30:00+00:00,9,10,0,1,17498.36,1
2024-01-25 14:30:00+00:00,14,22,0,8,17610.23,8
2024-01-25 15:30:00+00:00,9,24,0,15,17605.23,15
2024-01-25 16:30:00+00:00,10,21,0,11,17560.03,11
2024-01-25 17:30:00+00:00,11,15,0,4,17509.89,4
2024-01-25 18:30:00+00:00,13,11,2,0,17457.45,-2
2024-01-25 19:30:00+00:00,14,11,3,0,17480.60,-3
2024-01-25 20:30:00+00:00,14,13,1,0,17519.72,-1
2024-01-26 14:30:00+00:00,23,3,20,0,17466.57,-20
2024-01-26 15:30:00+00:00,21,8,13,0,17497.72,-13
2024-01-26 16:30:00+00:00,22,7,15,0,17486.48,-15
2024-01-26 17:30:00+00:00,24,7,17,0,17427.76,-17
2024-01-26 18:30:00+00:00,20,7,13,0,17416.34,-13
2024-01-26 19:30:00+00:00,16,16,0,0,17425.81,0
2024-01-26 20:30:00+00:00,20,14,6,0,17417.17,-6
2024-01-29 14:30:00+00:00,23,9,14,0,17435.14,-14
2024-01-29 15:30:00+00:00,22,13,9,0,17448.24,-9
2024-01-29 16:30:00+00:00,16,16,0,0,17482.77,0
2024-01-29 17:30:00+00:00,16,17,0,1,17485.39,1
2024-01-29 18:30:00+00:00,14,22,0,8,17507.01,8
2024-01-29 19:30:00+00:00,10,31,0,21,17592.26,21
2024-01-29 20:30:00+00:00,10,23,0,13,17596.40,13
2024-01-30 14:30:00+00:00,8,16,0,8,17546.46,8
2024-01-30 15:30:00+00:00,6,13,0,7,17533.38,7
2024-01-30 16:30:00+00:00,7,10,0,3,17477.74,3
2024-01-30 17:30:00+00:00,7,13,0,6,17488.48,6
2024-01-30 18:30:00+00:00,8,18,0,10,17475.54,10
2024-01-30 19:30:00+00:00,8,17,0,9,17492.37,9
2024-01-30 20:30:00+00:00,7,19,0,12,17478.46,12
2024-01-31 14:30:00+00:00,17,11,6,0,17222.78,-6
2024-01-31 15:30:00+00:00,14,6,8,0,17229.89,-8
2024-01-31 16:30:00+00:00,14,4,10,0,17253.28,-10
2024-01-31 17:30:00+00:00,11,5,6,0,17273.05,-6
2024-01-31 18:30:00+00:00,19,1,18,0,17228.93,-18
2024-01-31 19:30:00+00:00,34,0,34,0,17195.19,-34
2024-01-31 20:30:00+00:00,41,1,40,0,17137.77,-40
2024-02-01 14:30:00+00:00,23,3,20,0,17268.89,-20
2024-02-01 15:30:00+00:00,28,1,27,0,17185.77,-27
2024-02-01 16:30:00+00:00,12,3,9,0,17251.17,-9
2024-02-01 17:30:00+00:00,12,4,8,0,17275.22,-8
2024-02-01 18:30:00+00:00,8,4,4,0,17299.90,-4
2024-02-01 19:30:00+00:00,11,4,7,0,17343.72,-7
2024-02-01 20:30:00+00:00,9,4,5,0,17342.91,-5
2024-02-02 14:30:00+00:00,17,18,0,1,17491.52,1
2024-02-02 15:30:00+00:00,13,20,0,7,17579.38,7
2024-02-02 16:30:00+00:00,15,19,0,4,17654.95,4
2024-02-02 17:30:00+00:00,14,16,0,2,17614.98,2
2024-02-02 18:30:00+00:00,12,25,0,13,17655.05,13
2024-02-02 19:30:00+00:00,6,31,0,25,17671.62,25
2024-02-02 20:30:00+00:00,7,31,0,24,17640.16,24
2024-02-05 14:30:00+00:00,7,12,0,5,17537.00,5
2024-02-05 15:30:00+00:00,6,19,0,13,17524.56,13
2024-02-05 16:30:00+00:00,8,17,0,9,17598.22,9
2024-02-05 17:30:00+00:00,11,16,0,5,17595.44,5
2024-02-05 18:30:00+00:00,11,19,0,8,17622.69,8
2024-02-05 19:30:00+00:00,9,17,0,8,17623.58,8
2024-02-05 20:30:00+00:00,13,16,0,3,17607.32,3
2024-02-06 14:30:00+00:00,8,15,0,7,17535.44,7
2024-02-06 15:30:00+00:00,10,14,0,4,17566.90,4
2024-02-06 16:30:00+00:00,14,13,1,0,17514.08,-1
2024-02-06 17:30:00+00:00,10,12,0,2,17519.29,2
2024-02-06 18:30:00+00:00,19,11,8,0,17507.82,-8
2024-02-06 19:30:00+00:00,17,10,7,0,17547.99,-7
2024-02-06 20:30:00+00:00,9,15,0,6,17571.66,6
2024-02-07 14:30:00+00:00,2,38,0,36,17774.83,36
2024-02-07 15:30:00+00:00,4,33,0,29,17739.28,29
2024-02-07 16:30:00+00:00,4,30,0,26,17734.37,26
2024-02-07 17:30:00+00:00,5,29,0,24,17758.09,24
2024-02-07 18:30:00+00:00,5,27,0,22,17752.17,22
2024-02-07 19:30:00+00:00,5,23,0,18,17766.50,18
2024-02-07 20:30:00+00:00,4,25,0,21,17753.53,21
2024-02-08 14:30:00+00:00,8,23,0,15,17760.24,15
2024-02-08 15:30:00+00:00,11,23,0,12,17782.49,12
2024-02-08 16:30:00+00:00,13,32,0,19,17811.07,19
2024-02-08 17:30:00+00:00,13,33,0,20,17800.68,20
2024-02-08 18:30:00+00:00,10,33,0,23,17763.88,23
2024-02-08 19:30:00+00:00,11,31,0,20,17792.27,20
2024-02-08 20:30:00+00:00,9,24,0,15,17784.34,15
2024-02-09 14:30:00+00:00,13,20,0,7,17891.15,7
2024-02-09 15:30:00+00:00,14,23,0,9,17902.62,9
2024-02-09 16:30:00+00:00,12,28,0,16,17920.04,16
2024-02-09 17:30:00+00:00,11,27,0,16,17953.55,16
2024-02-09 18:30:00+00:00,9,26,0,17,17968.56,17
2024-02-09 19:30:00+00:00,6,27,0,21,17960.85,21
2024-02-09 20:30:00+00:00,4,26,0,22,17958.61,22
2024-02-12 14:30:00+00:00,6,17,0,11,17957.35,11
2024-02-12 15:30:00+00:00,3,26,0,23,18013.82,23
2024-02-12 16:30:00+00:00,3,26,0,23,18001.37,23
2024-02-12 17:30:00+00:00,8,28,0,20,17980.06,20
2024-02-12 18:30:00+00:00,8,24,0,16,17899.99,16
2024-02-12 19:30:00+00:00,6,19,0,13,17897.33,13
2024-02-12 20:30:00+00:00,4,20,0,16,17885.04,16
2024-02-13 14:30:00+00:00,29,4,25,0,17665.54,-25
2024-02-13 15:30:00+00:00,24,2,22,0,17681.26,-22
2024-02-13 16:30:00+00:00,33,3,30,0,17620.25,-30
2024-02-13 17:30:00+00:00,40,2,38,0,17613.91,-38
2024-02-13 18:30:00+00:00,49,1,48,0,17545.01,-48
2024-02-13 19:30:00+00:00,48,3,45,0,17501.97,-45
2024-02-13 20:30:00+00:00,35,2,33,0,17603.03,-33
2024-02-14 14:30:00+00:00,17,1,16,0,17762.63,-16
2024-02-14 15:30:00+00:00,22,2,20,0,17678.82,-20
2024-02-14 16:30:00+00:00,22,1,21,0,17686.41,-21
2024-02-14 17:30:00+00:00,19,4,15,0,17685.85,-15
2024-02-14 18:30:00+00:00,18,2,16,0,17705.50,-16
2024-02-14 19:30:00+00:00,12,5,7,0,17764.60,-7
2024-02-14 20:30:00+00:00,10,5,5,0,17806.37,-5
2024-02-15 14:30:00+00:00,2,23,0,21,17756.04,21
2024-02-15 15:30:00+00:00,3,22,0,19,17765.27,19
2024-02-15 16:30:00+00:00,1,29,0,28,17801.70,28
2024-02-15 17:30:00+00:00,0,35,0,35,17853.63,35
2024-02-15 18:30:00+00:00,0,50,0,50,17841.56,50
2024-02-15 19:30:00+00:00,0,49,0,49,17829.53,49
2024-02-15 20:30:00+00:00,1,41,0,40,17847.68,40
2024-02-16 14:30:00+00:00,12,24,0,12,17706.54,12
2024-02-16 15:30:00+00:00,3,36,0,33,17802.33,33
2024-02-16 16:30:00+00:00,3,37,0,34,17816.25,34
2024-02-16 17:30:00+00:00,6,32,0,26,17771.58,26
2024-02-16 18:30:00+00:00,4,31,0,27,17825.61,27
2024-02-16 19:30:00+00:00,9,13,0,4,17726.77,4
2024-02-16 20:30:00+00:00,11,14,0,3,17683.69,3
2024-02-20 14:30:00+00:00,20,6,14,0,17450.18,-14
2024-02-20 15:30:00+00:00,12,6,6,0,17513.45,-6
2024-02-20 16:30:00+00:00,24,4,20,0,17416.30,-20
2024-02-20 17:30:00+00:00,26,5,21,0,17436.43,-21
2024-02-20 18:30:00+00:00,20,4,16,0,17478.52,-16
2024-02-20 19:30:00+00:00,17,5,12,0,17527.43,-12
2024-02-20 20:30:00+00:00,17,4,13,0,17550.77,-13
2024-02-21 14:30:00+00:00,20,5,15,0,17419.57,-15
2024-02-21 15:30:00+00:00,32,4,28,0,17432.41,-28
2024-02-21 16:30:00+00:00,33,3,30,0,17391.47,-30
2024-02-21 17:30:00+00:00,29,2,27,0,17397.69,-27
2024-02-21 18:30:00+00:00,40,1,39,0,17355.74,-39
2024-02-21 19:30:00+00:00,22,3,19,0,17359.85,-19
2024-02-21 20:30:00+00:00,12,6,6,0,17478.22,-6
2024-02-22 14:30:00+00:00,6,27,0,21,17902.21,21
2024-02-22 15:30:00+00:00,5,25,0,20,17905.13,20
2024-02-22 16:30:00+00:00,3,42,0,39,17938.84,39
2024-02-22 17:30:00+00:00,2,45,0,43,17971.49,43
2024-02-22 18:30:00+00:00,1,46,0,45,18033.69,45
2024-02-22 19:30:00+00:00,3,40,0,37,18008.15,37
2024-02-22 20:30:00+00:00,4,33,0,29,17998.55,29
2024-02-23 14:30:00+00:00,3,47,0,44,18002.25,44
2024-02-23 15:30:00+00:00,2,40,0,38,17959.75,38
2024-02-23 16:30:00+00:00,1,44,0,43,17972.68,43
2024-02-23 17:30:00+00:00,3,49,0,46,18004.15,46
2024-02-23 18:30:00+00:00,2,47,0,45,17947.84,45
2024-02-23 19:30:00+00:00,2,45,0,43,17925.29,43
2024-02-23 20:30:00+00:00,4,38,0,34,17937.28,34
2024-02-26 14:30:00+00:00,5,22,0,17,17976.50,17
2024-02-26 15:30:00+00:00,6,21,0,15,17971.54,15
2024-02-26 16:30:00+00:00,11,21,0,10,18004.76,10
2024-02-26 17:30:00+00:00,11,12,0,1,17955.24,1
2024-02-26 18:30:00+00:00,17,12,5,0,17985.27,-5
2024-02-26 19:30:00+00:00,12,14,0,2,17968.47,2
2024-02-26 20:30:00+00:00,10,11,0,1,17931.81,1
2024-02-27 14:30:00+00:00,16,18,0,2,17966.46,2
2024-02-27 15:30:00+00:00,17,15,2,0,17934.92,-2
2024-02-27 16:30:00+00:00,14,10,4,0,17933.05,-4
2024-02-27 17:30:00+00:00,22,7,15,0,17900.88,-15
2024-02-27 18:30:00+00:00,16,17,0,1,17962.25,1
2024-02-27 19:30:00+00:00,15,17,0,2,17981.20,2
2024-02-27 20:30:00+00:00,12,14,0,2,17974.48,2
2024-02-28 14:30:00+00:00,17,8,9,0,17859.90,-9
2024-02-28 15:30:00+00:00,11,10,1,0,17918.22,-1
2024-02-28 16:30:00+00:00,15,11,4,0,17891.57,-4
2024-02-28 17:30:00+00:00,7,11,0,4,17897.56,4
2024-02-28 18:30:00+00:00,17,9,8,0,17870.33,-8
2024-02-28 19:30:00+00:00,12,7,5,0,17885.08,-5
2024-02-28 20:30:00+00:00,10,11,0,1,17876.81,1
2024-02-29 14:30:00+00:00,11,8,3,0,17979.08,-3
2024-02-29 15:30:00+00:00,11,8,3,0,17942.56,-3
2024-02-29 16:30:00+00:00,11,7,4,0,17933.92,-4
2024-02-29 17:30:00+00:00,9,12,0,3,18004.63,3
2024-02-29 18:30:00+00:00,13,8,5,0,17987.13,-5
2024-02-29 19:30:00+00:00,14,9,5,0,18009.00,-5
2024-02-29 20:30:00+00:00,15,9,6,0,18038.93,-6
2024-03-01 14:30:00+00:00,7,30,0,23,18143.86,23
2024-03-01 15:30:00+00:00,9,30,0,21,18193.18,21
2024-03-01 16:30:00+00:00,4,33,0,29,18228.61,29
2024-03-01 17:30:00+00:00,6,33,0,27,18279.65,27
2024-03-01 18:30:00+00:00,3,36,0,33,18329.59,33
2024-03-01 19:30:00+00:00,3,34,0,31,18307.02,31
2024-03-01 20:30:00+00:00,4,33,0,29,18304.81,29
2024-03-04 14:30:00+00:00,17,33,0,16,18255.70,16
2024-03-04 15:30:00+00:00,13,31,0,18,18271.32,18
2024-03-04 16:30:00+00:00,14,34,0,20,18289.52,20
2024-03-04 17:30:00+00:00,16,29,0,13,18253.89,13
2024-03-04 18:30:00+00:00,17,27,0,10,18268.68,10
2024-03-04 19:30:00+00:00,14,30,0,16,18288.71,16
2024-03-04 20:30:00+00:00,15,25,0,10,18227.95,10
2024-03-05 14:30:00+00:00,28,11,17,0,17931.23,-17
2024-03-05 15:30:00+00:00,30,10,20,0,17926.89,-20
2024-03-05 16:30:00+00:00,31,7,24,0,17945.30,-24
2024-03-05 17:30:00+00:00,36,8,28,0,17893.88,-28
2024-03-05 18:30:00+00:00,48,4,44,0,17867.77,-44
2024-03-05 19:30:00+00:00,49,3,46,0,17810.10,-46
2024-03-05 20:30:00+00:00,37,3,34,0,17898.28,-34
2024-03-06 14:30:00+00:00,23,5,18,0,17990.17,-18
2024-03-06 15:30:00+00:00,18,7,11,0,18067.52,-11
2024-03-06 16:30:00+00:00,15,6,9,0,18127.50,-9
2024-03-06 17:30:00+00:00,11,7,4,0,18123.96,-4
2024-03-06 18:30:00+00:00,15,7,8,0,18048.57,-8
2024-03-06 19:30:00+00:00,19,5,14,0,17989.42,-14
2024-03-06 20:30:00+00:00,16,6,10,0,18015.80,-10
2024-03-07 14:30:00+00:00,4,20,0,16,18217.01,16
2024-03-07 15:30:00+00:00,3,23,0,20,18267.61,20
2024-03-07 16:30:00+00:00,3,30,0,27,18291.02,27
2024-03-07 17:30:00+00:00,2,33,0,31,18306.44,31
2024-03-07 18:30:00+00:00,1,36,0,35,18319.65,35
2024-03-07 19:30:00+00:00,1,43,0,42,18282.85,42
2024-03-07 20:30:00+00:00,3,31,0,28,18301.64,28
2024-03-08 14:30:00+00:00,5,33,0,28,18408.61,28
2024-03-08 15:30:00+00:00,3,14,0,11,18178.63,11
2024-03-08 16:30:00+00:00,3,13,0,10,18166.22,10
2024-03-08 17:30:00+00:00,4,8,0,4,18042.94,4
2024-03-08 18:30:00+00:00,3,14,0,11,18098.64,11
2024-03-08 19:30:00+00:00,4,8,0,4,18036.46,4
2024-03-08 20:30:00+00:00,5,8,0,3,18020.67,3
2024-03-11 13:30:00+00:00,20,12,8,0,17910.88,-8
2024-03-11 14:30:00+00:00,25,16,9,0,17914.41,-9
2024-03-11 15:30:00+00:00,24,17,7,0,17955.86,-7
2024-03-11 16:30:00+00:00,24,18,6,0,17974.06,-6
2024-03-11 17:30:00+00:00,21,13,8,0,17974.92,-8
2024-03-11 18:30:00+00:00,19,13,6,0,17942.05,-6
2024-03-11 19:30:00+00:00,17,16,1,0,17953.34,-1
2024-03-12 13:30:00+00:00,15,13,2,0,18105.08,-2
2024-03-12 14:30:00+00:00,8,13,0,5,18193.14,5
2024-03-12 15:30:00+00:00,13,10,3,0,18124.39,-3
2024-03-12 16:30:00+00:00,7,15,0,8,18122.95,8
2024-03-12 17:30:00+00:00,5,16,0,11,18179.47,11
2024-03-12 18:30:00+00:00,4,23,0,19,18206.17,19
2024-03-12 19:30:00+00:00,5,22,0,17,18217.64,17
2024-03-13 13:30:00+00:00,2,24,0,22,18092.48,22
2024-03-13 14:30:00+00:00,2,21,0,19,18065.74,19
2024-03-13 15:30:00+00:00,5,20,0,15,18075.53,15
2024-03-13 16:30:00+00:00,4,22,0,18,18122.17,18
2024-03-13 17:30:00+00:00,7,19,0,12,18123.47,12
2024-03-13 18:30:00+00:00,9,13,0,4,18056.13,4
2024-03-13 19:30:00+00:00,11,12,0,1,18068.33,1
2024-03-14 13:30:00+00:00,22,7,15,0,18062.02,-15
2024-03-14 14:30:00+00:00,25,7,18,0,18026.19,-18
2024-03-14 15:30:00+00:00,17,8,9,0,18029.38,-9
2024-03-14 16:30:00+00:00,22,8,14,0,17985.50,-14
2024-03-14 17:30:00+00:00,24,7,17,0,18048.97,-17
2024-03-14 18:30:00+00:00,33,6,27,0,17943.69,-27
2024-03-14 19:30:00+00:00,19,7,12,0,18020.71,-12
2024-03-15 13:30:00+00:00,27,1,26,0,17863.56,-26
2024-03-15 14:30:00+00:00,22,3,19,0,17857.44,-19
2024-03-15 15:30:00+00:00,28,2,26,0,17794.93,-26
2024-03-15 16:30:00+00:00,32,1,31,0,17806.24,-31
2024-03-15 17:30:00+00:00,34,2,32,0,17812.14,-32
2024-03-15 18:30:00+00:00,22,5,17,0,17842.47,-17
2024-03-15 19:30:00+00:00,28,5,23,0,17811.34,-23
2024-03-18 13:30:00+00:00,7,12,0,5,18112.52,5
2024-03-18 14:30:00+00:00,4,15,0,11,18068.13,11
2024-03-18 15:30:00+00:00,6,9,0,3,18043.32,3
2024-03-18 16:30:00+00:00,4,14,0,10,18035.38,10
2024-03-18 17:30:00+00:00,6,11,0,5,18057.89,5
2024-03-18 18:30:00+00:00,5,14,0,9,18033.54,9
2024-03-18 19:30:00+00:00,13,10,3,0,17984.28,-3
2024-03-19 13:30:00+00:00,16,11,5,0,17835.30,-5
2024-03-19 14:30:00+00:00,5,8,0,3,17885.13,3
2024-03-19 15:30:00+00:00,1,13,0,12,17952.98,12
2024-03-19 16:30:00+00:00,2,16,0,14,18005.83,14
2024-03-19 17:30:00+00:00,0,14,0,14,18022.45,14
2024-03-19 18:30:00+00:00,3,10,0,7,17987.51,7
2024-03-19 19:30:00+00:00,1,14,0,13,18028.55,13
2024-03-20 13:30:00+00:00,11,11,0,0,18052.17,0
2024-03-20 14:30:00+00:00,8,7,1,0,18044.75,-1
2024-03-20 15:30:00+00:00,6,6,0,0,18036.73,0
2024-03-20 16:30:00+00:00,9,3,6,0,18021.08,-6
2024-03-20 17:30:00+00:00,2,10,0,8,18121.92,8
2024-03-20 18:30:00+00:00,1,17,0,16,18236.73,16
2024-03-20 19:30:00+00:00,1,20,0,19,18238.61,19
2024-03-21 13:30:00+00:00,2,56,0,54,18420.41,54
2024-03-21 14:30:00+00:00,0,48,0,48,18415.80,48
2024-03-21 15:30:00+00:00,0,45,0,45,18461.84,45
2024-03-21 16:30:00+00:00,1,39,0,38,18424.46,38
2024-03-21 17:30:00+00:00,1,36,0,35,18375.24,35
2024-03-21 18:30:00+00:00,1,39,0,38,18347.46,38
2024-03-21 19:30:00+00:00,2,30,0,28,18317.10,28
2024-03-22 13:30:00+00:00,3,24,0,21,18296.78,21
2024-03-22 14:30:00+00:00,4,22,0,18,18317.25,18
2024-03-22 15:30:00+00:00,3,18,0,15,18316.58,15
2024-03-22 16:30:00+00:00,4,25,0,21,18360.20,21
2024-03-22 17:30:00+00:00,8,15,0,7,18372.67,7
2024-03-22 18:30:00+00:00,13,7,6,0,18335.16,-6
2024-03-22 19:30:00+00:00,11,6,5,0,18339.91,-5
2024-03-25 13:30:00+00:00,28,4,24,0,18280.68,-24
2024-03-25 14:30:00+00:00,26,4,22,0,18296.80,-22
2024-03-25 15:30:00+00:00,33,2,31,0,18293.07,-31
2024-03-25 16:30:00+00:00,25,3,22,0,18312.79,-22
2024-03-25 17:30:00+00:00,23,7,16,0,18327.67,-16
2024-03-25 18:30:00+00:00,21,7,14,0,18299.34,-14
2024-03-25 19:30:00+00:00,23,6,17,0,18279.07,-17
2024-03-26 13:30:00+00:00,8,8,0,0,18330.90,0
2024-03-26 14:30:00+00:00,10,11,0,1,18340.23,1
2024-03-26 15:30:00+00:00,7,11,0,4,18333.08,4
2024-03-26 16:30:00+00:00,19,11,8,0,18320.82,-8
2024-03-26 17:30:00+00:00,17,7,10,0,18329.02,-10
2024-03-26 18:30:00+00:00,17,9,8,0,18281.26,-8
2024-03-26 19:30:00+00:00,19,5,14,0,18213.69,-14
2024-03-27 13:30:00+00:00,11,15,0,4,18193.67,4
2024-03-27 14:30:00+00:00,10,11,0,1,18183.72,1
2024-03-27 15:30:00+00:00,10,12,0,2,18213.83,2
2024-03-27 16:30:00+00:00,10,13,0,3,18206.71,3
2024-03-27 17:30:00+00:00,7,13,0,6,18232.17,6
2024-03-27 18:30:00+00:00,8,12,0,4,18211.10,4
2024-03-27 19:30:00+00:00,2,16,0,14,18283.42,14
2024-03-28 13:30:00+00:00,11,24,0,13,18265.88,13
2024-03-28 14:30:00+00:00,7,26,0,19,18279.18,19
2024-03-28 15:30:00+00:00,8,24,0,16,18264.06,16
2024-03-28 16:30:00+00:00,8,22,0,14,18243.32,14
2024-03-28 17:30:00+00:00,10,22,0,12,18254.98,12
2024-03-28 18:30:00+00:00,7,24,0,17,18280.95,17
2024-03-28 19:30:00+00:00,5,21,0,16,18242.98,16
2024-04-01 14:30:00+01:00,7,17,0,10,18324.64,10
2024-04-01 15:30:00+01:00,8,13,0,5,18261.29,5
2024-04-01 16:30:00+01:00,14,14,0,0,18264.74,0
2024-04-01 17:30:00+01:00,14,11,3,0,18240.49,-3
2024-04-01 18:30:00+01:00,13,8,5,0,18261.53,-5
2024-04-01 19:30:00+01:00,12,8,4,0,18259.06,-4
2024-04-01 20:30:00+01:00,15,7,8,0,18290.73,-8
2024-04-02 14:30:00+01:00,43,1,42,0,18035.23,-42
2024-04-02 15:30:00+01:00,41,0,41,0,18062.50,-41
2024-04-02 16:30:00+01:00,43,1,42,0,18048.26,-42
2024-04-02 17:30:00+01:00,39,3,36,0,18075.31,-36
2024-04-02 18:30:00+01:00,41,1,40,0,18078.11,-40
2024-04-02 19:30:00+01:00,39,1,38,0,18098.86,-38
2024-04-02 20:30:00+01:00,37,4,33,0,18122.09,-33
2024-04-03 14:30:00+01:00,21,2,19,0,18201.05,-19
2024-04-03 15:30:00+01:00,17,3,14,0,18232.69,-14
2024-04-03 16:30:00+01:00,17,4,13,0,18213.86,-13
2024-04-03 17:30:00+01:00,19,5,14,0,18212.85,-14
2024-04-03 18:30:00+01:00,18,6,12,0,18202.16,-12
2024-04-03 19:30:00+01:00,24,4,20,0,18126.59,-20
2024-04-03 20:30:00+01:00,24,4,20,0,18161.21,-20
2024-04-04 14:30:00+01:00,8,27,0,19,18306.26,19
2024-04-04 15:30:00+01:00,11,21,0,10,18297.50,10
2024-04-04 16:30:00+01:00,9,27,0,18,18349.41,18
2024-04-04 17:30:00+01:00,8,29,0,21,18338.44,21
2024-04-04 18:30:00+01:00,14,5,9,0,18138.27,-9
2024-04-04 19:30:00+01:00,25,0,25,0,17915.79,-25
2024-04-04 20:30:00+01:00,29,0,29,0,17876.18,-29
2024-04-05 14:30:00+01:00,23,0,23,0,18008.33,-23
2024-04-05 15:30:00+01:00,13,0,13,0,18082.32,-13
2024-04-05 16:30:00+01:00,8,1,7,0,18157.64,-7
2024-04-05 17:30:00+01:00,9,1,8,0,18166.88,-8
2024-04-05 18:30:00+01:00,8,0,8,0,18087.74,-8
2024-04-05 19:30:00+01:00,5,0,5,0,18092.24,-5
2024-04-05 20:30:00+01:00,8,0,8,0,18105.88,-8
2024-04-08 14:30:00+01:00,17,0,17,0,18146.28,-17
2024-04-08 15:30:00+01:00,9,0,9,0,18141.29,-9
2024-04-08 16:30:00+01:00,16,0,16,0,18089.51,-16
2024-04-08 17:30:00+01:00,12,0,12,0,18114.74,-12
2024-04-08 18:30:00+01:00,3,6,0,3,18121.73,3
2024-04-08 19:30:00+01:00,2,24,0,22,18119.55,22
2024-04-08 20:30:00+01:00,3,28,0,25,18103.05,25
2024-04-09 14:30:00+01:00,5,31,0,26,18091.87,26
2024-04-09 15:30:00+01:00,15,21,0,6,18035.49,6
2024-04-09 16:30:00+01:00,13,18,0,5,18095.23,5
2024-04-09 17:30:00+01:00,13,16,0,3,18085.43,3
2024-04-09 18:30:00+01:00,8,24,0,16,18070.49,16
2024-04-09 19:30:00+01:00,7,28,0,21,18132.83,21
2024-04-09 20:30:00+01:00,6,32,0,26,18170.84,26
2024-04-10 14:30:00+01:00,10,4,6,0,17996.95,-6
2024-04-10 15:30:00+01:00,15,1,14,0,17992.63,-14
2024-04-10 16:30:00+01:00,17,1,16,0,17965.04,-16
2024-04-10 17:30:00+01:00,16,1,15,0,17997.10,-15
2024-04-10 18:30:00+01:00,22,2,20,0,17961.80,-20
2024-04-10 19:30:00+01:00,9,4,5,0,18000.46,-5
2024-04-10 20:30:00+01:00,11,5,6,0,18010.08,-6
2024-04-11 14:30:00+01:00,26,2,24,0,18034.73,-24
2024-04-11 15:30:00+01:00,19,5,14,0,18071.51,-14
2024-04-11 16:30:00+01:00,18,3,15,0,18120.93,-15
2024-04-11 17:30:00+01:00,7,8,0,1,18233.24,1
2024-04-11 18:30:00+01:00,4,19,0,15,18312.90,15
2024-04-11 19:30:00+01:00,8,17,0,9,18322.13,9
2024-04-11 20:30:00+01:00,12,13,0,1,18306.98,1
2024-04-12 14:30:00+01:00,14,10,4,0,18105.65,-4
2024-04-12 15:30:00+01:00,10,7,3,0,18089.90,-3
2024-04-12 16:30:00+01:00,12,6,6,0,18032.88,-6
2024-04-12 17:30:00+01:00,20,2,18,0,17965.69,-18
2024-04-12 18:30:00+01:00,12,3,9,0,17996.56,-9
2024-04-12 19:30:00+01:00,17,2,15,0,17966.85,-15
2024-04-12 20:30:00+01:00,11,4,7,0,18005.96,-7
2024-04-15 14:30:00+01:00,13,3,10,0,18056.50,-10
2024-04-15 15:30:00+01:00,13,3,10,0,18023.24,-10
2024-04-15 16:30:00+01:00,19,2,17,0,17966.62,-17
2024-04-15 17:30:00+01:00,51,0,51,0,17786.44,-51
2024-04-15 18:30:00+01:00,75,0,75,0,17731.37,-75
2024-04-15 19:30:00+01:00,74,3,71,0,17693.51,-71
2024-04-15 20:30:00+01:00,66,1,65,0,17707.81,-65
2024-04-16 14:30:00+01:00,47,2,45,0,17700.89,-45
2024-04-16 15:30:00+01:00,33,1,32,0,17745.20,-32
2024-04-16 16:30:00+01:00,26,0,26,0,17734.99,-26
2024-04-16 17:30:00+01:00,21,1,20,0,17734.24,-20
2024-04-16 18:30:00+01:00,32,2,30,0,17694.53,-30
2024-04-16 19:30:00+01:00,17,1,16,0,17779.68,-16
2024-04-16 20:30:00+01:00,27,1,26,0,17711.69,-26
2024-04-17 14:30:00+01:00,29,0,29,0,17688.77,-29
2024-04-17 15:30:00+01:00,39,0,39,0,17615.80,-39
2024-04-17 16:30:00+01:00,44,1,43,0,17523.78,-43
2024-04-17 17:30:00+01:00,13,3,10,0,17549.06,-10
2024-04-17 18:30:00+01:00,8,8,0,0,17553.38,0
2024-04-17 19:30:00+01:00,11,6,5,0,17494.33,-5
2024-04-17 20:30:00+01:00,16,8,8,0,17491.16,-8
2024-04-18 14:30:00+01:00,18,12,6,0,17506.23,-6
2024-04-18 15:30:00+01:00,20,10,10,0,17555.89,-10
2024-04-18 16:30:00+01:00,25,9,16,0,17533.25,-16
2024-04-18 17:30:00+01:00,30,9,21,0,17437.41,-21
2024-04-18 18:30:00+01:00,25,9,16,0,17412.26,-16
2024-04-18 19:30:00+01:00,34,8,26,0,17410.54,-26
2024-04-18 20:30:00+01:00,30,10,20,0,17394.11,-20
2024-04-19 14:30:00+01:00,34,9,25,0,17220.98,-25
2024-04-19 15:30:00+01:00,34,10,24,0,17186.54,-24
2024-04-19 16:30:00+01:00,38,8,30,0,17064.10,-30
2024-04-19 17:30:00+01:00,33,10,23,0,17118.75,-23
2024-04-19 18:30:00+01:00,36,10,26,0,17071.26,-26
2024-04-19 19:30:00+01:00,33,11,22,0,17038.79,-22
2024-04-19 20:30:00+01:00,33,11,22,0,17038.07,-22
2024-04-22 14:30:00+01:00,30,13,17,0,17049.47,-17
2024-04-22 15:30:00+01:00,43,11,32,0,17062.19,-32
2024-04-22 16:30:00+01:00,31,13,18,0,17118.35,-18
2024-04-22 17:30:00+01:00,13,23,0,10,17199.38,10
2024-04-22 18:30:00+01:00,2,27,0,25,17286.28,25
2024-04-22 19:30:00+01:00,5,20,0,15,17249.48,15
2024-04-22 20:30:00+01:00,6,18,0,12,17212.79,12
2024-04-23 14:30:00+01:00,0,22,0,22,17425.78,22
2024-04-23 15:30:00+01:00,0,37,0,37,17449.87,37
2024-04-23 16:30:00+01:00,0,51,0,51,17465.49,51
2024-04-23 17:30:00+01:00,0,44,0,44,17458.10,44
2024-04-23 18:30:00+01:00,0,58,0,58,17507.79,58
2024-04-23 19:30:00+01:00,0,56,0,56,17487.27,56
2024-04-23 20:30:00+01:00,0,54,0,54,17471.73,54
2024-04-24 14:30:00+01:00,3,54,0,51,17590.82,51
2024-04-24 15:30:00+01:00,1,48,0,47,17520.86,47
2024-04-24 16:30:00+01:00,0,37,0,37,17470.03,37
2024-04-24 17:30:00+01:00,1,31,0,30,17515.27,30
2024-04-24 18:30:00+01:00,1,25,0,24,17502.87,24
2024-04-24 19:30:00+01:00,0,33,0,33,17533.27,33
2024-04-24 20:30:00+01:00,1,34,0,33,17528.63,33
2024-04-25 14:30:00+01:00,19,10,9,0,17306.91,-9
2024-04-25 15:30:00+01:00,19,8,11,0,17278.41,-11
2024-04-25 16:30:00+01:00,15,8,7,0,17333.62,-7
2024-04-25 17:30:00+01:00,13,10,3,0,17366.73,-3
2024-04-25 18:30:00+01:00,11,8,3,0,17390.55,-3
2024-04-25 19:30:00+01:00,9,14,0,5,17468.95,5
2024-04-25 20:30:00+01:00,6,13,0,7,17431.90,7
2024-04-26 14:30:00+01:00,9,14,0,5,17675.45,5
2024-04-26 15:30:00+01:00,10,19,0,9,17709.61,9
2024-04-26 16:30:00+01:00,10,22,0,12,17718.58,12
2024-04-26 17:30:00+01:00,10,24,0,14,17763.23,14
2024-04-26 18:30:00+01:00,9,22,0,13,17721.03,13
2024-04-26 19:30:00+01:00,9,21,0,12,17759.12,12
2024-04-26 20:30:00+01:00,10,21,0,11,17712.14,11
2024-04-29 14:30:00+01:00,5,39,0,34,17771.32,34
2024-04-29 15:30:00+01:00,6,38,0,32,17754.19,32
2024-04-29 16:30:00+01:00,9,38,0,29,17780.46,29
2024-04-29 17:30:00+01:00,6,34,0,28,17799.07,28
2024-04-29 18:30:00+01:00,8,32,0,24,17763.21,24
2024-04-29 19:30:00+01:00,8,21,0,13,17722.92,13
2024-04-29 20:30:00+01:00,8,30,0,22,17783.93,22
2024-04-30 14:30:00+01:00,13,10,3,0,17710.96,-3
2024-04-30 15:30:00+01:00,19,11,8,0,17649.13,-8
2024-04-30 16:30:00+01:00,20,7,13,0,17643.67,-13
2024-04-30 17:30:00+01:00,31,6,25,0,17578.48,-25
2024-04-30 18:30:00+01:00,29,6,23,0,17571.43,-23
2024-04-30 19:30:00+01:00,31,4,27,0,17569.29,-27
2024-04-30 20:30:00+01:00,33,4,29,0,17445.04,-29
2024-05-01 14:30:00+01:00,44,2,42,0,17352.29,-42
2024-05-01 15:30:00+01:00,44,3,41,0,17336.27,-41
2024-05-01 16:30:00+01:00,40,4,36,0,17346.02,-36
2024-05-01 17:30:00+01:00,43,4,39,0,17331.24,-39
2024-05-01 18:30:00+01:00,28,4,24,0,17443.55,-24
2024-05-01 19:30:00+01:00,12,11,1,0,17598.71,-1
2024-05-01 20:30:00+01:00,32,2,30,0,17316.34,-30
2024-05-02 14:30:00+01:00,21,7,14,0,17390.93,-14
2024-05-02 15:30:00+01:00,18,8,10,0,17415.76,-10
2024-05-02 16:30:00+01:00,14,8,6,0,17431.38,-6
2024-05-02 17:30:00+01:00,8,10,0,2,17496.13,2
2024-05-02 18:30:00+01:00,8,10,0,2,17519.12,2
2024-05-02 19:30:00+01:00,7,11,0,4,17564.24,4
2024-05-02 20:30:00+01:00,9,16,0,7,17545.36,7
2024-05-03 14:30:00+01:00,2,29,0,27,17834.10,27
2024-05-03 15:30:00+01:00,3,25,0,22,17834.31,22
2024-05-03 16:30:00+01:00,3,28,0,25,17875.40,25
2024-05-03 17:30:00+01:00,3,24,0,21,17881.85,21
2024-05-03 18:30:00+01:00,4,16,0,12,17908.99,12
2024-05-03 19:30:00+01:00,8,13,0,5,17908.11,5
2024-05-03 20:30:00+01:00,5,49,0,44,17891.28,44
2024-05-06 14:30:00+01:00,3,49,0,46,17994.79,46
2024-05-06 15:30:00+01:00,3,44,0,41,17992.58,41
2024-05-06 16:30:00+01:00,4,41,0,37,17982.09,37
2024-05-06 17:30:00+01:00,4,41,0,37,18005.52,37
2024-05-06 18:30:00+01:00,5,42,0,37,18038.77,37
2024-05-06 19:30:00+01:00,9,38,0,29,18035.29,29
2024-05-06 20:30:00+01:00,6,40,0,34,18093.48,34
2024-05-07 14:30:00+01:00,6,32,0,26,18083.70,26
2024-05-07 15:30:00+01:00,4,38,0,34,18139.65,34
2024-05-07 16:30:00+01:00,8,33,0,25,18150.28,25
2024-05-07 17:30:00+01:00,5,35,0,30,18147.11,30
2024-05-07 18:30:00+01:00,8,19,0,11,18079.08,11
2024-05-07 19:30:00+01:00,8,22,0,14,18092.65,14
2024-05-07 20:30:00+01:00,9,20,0,11,18091.04,11
2024-05-08 14:30:00+01:00,13,15,0,2,18101.82,2
2024-05-08 15:30:00+01:00,10,18,0,8,18084.13,8
2024-05-08 16:30:00+01:00,11,15,0,4,18076.44,4
2024-05-08 17:30:00+01:00,14,10,4,0,18043.09,-4
2024-05-08 18:30:00+01:00,12,11,1,0,18081.35,-1
2024-05-08 19:30:00+01:00,12,11,1,0,18080.91,-1
2024-05-08 20:30:00+01:00,15,8,7,0,18084.64,-7
2024-05-09 14:30:00+01:00,12,9,3,0,18055.01,-3
2024-05-09 15:30:00+01:00,11,14,0,3,18128.83,3
2024-05-09 16:30:00+01:00,13,14,0,1,18100.09,1
2024-05-09 17:30:00+01:00,12,15,0,3,18121.96,3
2024-05-09 18:30:00+01:00,11,16,0,5,18117.65,5
2024-05-09 19:30:00+01:00,11,14,0,3,18112.32,3
2024-05-09 20:30:00+01:00,10,14,0,4,18115.75,4
2024-05-10 14:30:00+01:00,3,19,0,16,18135.55,16
2024-05-10 15:30:00+01:00,5,24,0,19,18142.07,19
2024-05-10 16:30:00+01:00,6,23,0,17,18138.64,17
2024-05-10 17:30:00+01:00,3,26,0,23,18129.29,23
2024-05-10 18:30:00+01:00,5,25,0,20,18152.69,20
2024-05-10 19:30:00+01:00,4,27,0,23,18161.09,23
2024-05-10 20:30:00+01:00,6,27,0,21,18158.58,21
2024-05-13 14:30:00+01:00,3,31,0,28,18210.59,28
2024-05-13 15:30:00+01:00,9,22,0,13,18185.66,13
2024-05-13 16:30:00+01:00,7,20,0,13,18207.82,13
2024-05-13 17:30:00+01:00,9,17,0,8,18197.96,8
2024-05-13 18:30:00+01:00,11,18,0,7,18187.89,7
2024-05-13 19:30:00+01:00,10,21,0,11,18192.44,11
2024-05-13 20:30:00+01:00,9,22,0,13,18199.72,13
2024-05-14 14:30:00+01:00,8,21,0,13,18267.71,13
2024-05-14 15:30:00+01:00,10,22,0,12,18264.22,12
2024-05-14 16:30:00+01:00,13,20,0,7,18218.06,7
2024-05-14 17:30:00+01:00,15,15,0,0,18227.77,0
2024-05-14 18:30:00+01:00,12,22,0,10,18283.20,10
2024-05-14 19:30:00+01:00,8,22,0,14,18323.45,14
2024-05-14 20:30:00+01:00,8,26,0,18,18319.70,18
2024-05-15 14:30:00+01:00,9,22,0,13,18436.66,13
2024-05-15 15:30:00+01:00,3,27,0,24,18498.87,24
2024-05-15 16:30:00+01:00,2,31,0,29,18512.98,29
2024-05-15 17:30:00+01:00,1,37,0,36,18556.27,36
2024-05-15 18:30:00+01:00,0,37,0,37,18585.69,37
2024-05-15 19:30:00+01:00,3,39,0,36,18597.98,36
2024-05-15 20:30:00+01:00,2,36,0,34,18599.13,34
2024-05-16 14:30:00+01:00,5,30,0,25,18627.69,25
2024-05-16 15:30:00+01:00,5,42,0,37,18656.10,37
2024-05-16 16:30:00+01:00,5,42,0,37,18634.13,37
2024-05-16 17:30:00+01:00,4,41,0,37,18599.40,37
2024-05-16 18:30:00+01:00,4,39,0,35,18586.06,35
2024-05-16 19:30:00+01:00,4,36,0,32,18597.10,32
2024-05-16 20:30:00+01:00,5,31,0,26,18557.98,26
2024-05-17 14:30:00+01:00,5,21,0,16,18575.97,16
2024-05-17 15:30:00+01:00,8,18,0,10,18565.58,10
2024-05-17 16:30:00+01:00,10,17,0,7,18552.53,7
2024-05-17 17:30:00+01:00,15,14,1,0,18534.32,-1
2024-05-17 18:30:00+01:00,24,8,16,0,18484.85,-16
2024-05-17 19:30:00+01:00,14,13,1,0,18543.39,-1
2024-05-17 20:30:00+01:00,15,13,2,0,18549.36,-2
2024-05-20 14:30:00+01:00,10,12,0,2,18663.87,2
2024-05-20 15:30:00+01:00,12,10,2,0,18664.30,-2
2024-05-20 16:30:00+01:00,16,8,8,0,18660.98,-8
2024-05-20 17:30:00+01:00,14,14,0,0,18659.16,0
2024-05-20 18:30:00+01:00,14,14,0,0,18660.44,0
2024-05-20 19:30:00+01:00,15,14,1,0,18688.86,-1
2024-05-20 20:30:00+01:00,14,18,0,4,18677.91,4
2024-05-21 14:30:00+01:00,17,13,4,0,18646.63,-4
2024-05-21 15:30:00+01:00,17,14,3,0,18669.88,-3
2024-05-21 16:30:00+01:00,17,15,2,0,18680.08,-2
2024-05-21 17:30:00+01:00,17,21,0,4,18671.16,4
2024-05-21 18:30:00+01:00,13,23,0,10,18671.90,10
2024-05-21 19:30:00+01:00,15,20,0,5,18687.86,5
2024-05-21 20:30:00+01:00,14,17,0,3,18714.74,3
2024-05-22 14:30:00+01:00,18,18,0,0,18735.70,0
2024-05-22 15:30:00+01:00,16,19,0,3,18752.65,3
2024-05-22 16:30:00+01:00,10,21,0,11,18739.61,11
2024-05-22 17:30:00+01:00,13,21,0,8,18737.03,8
2024-05-22 18:30:00+01:00,19,12,7,0,18613.46,-7
2024-05-22 19:30:00+01:00,21,12,9,0,18656.23,-9
2024-05-22 20:30:00+01:00,17,13,4,0,18706.81,-4
2024-05-23 14:30:00+01:00,21,16,5,0,18818.62,-5
2024-05-23 15:30:00+01:00,16,14,2,0,18822.13,-2
2024-05-23 16:30:00+01:00,16,15,1,0,18853.54,-1
2024-05-23 17:30:00+01:00,20,13,7,0,18775.24,-7
2024-05-23 18:30:00+01:00,29,8,21,0,18612.48,-21
2024-05-23 19:30:00+01:00,31,6,25,0,18580.27,-25
2024-05-23 20:30:00+01:00,33,7,26,0,18625.94,-26
2024-05-24 14:30:00+01:00,24,8,16,0,18759.53,-16
2024-05-24 15:30:00+01:00,18,9,9,0,18828.93,-9
2024-05-24 16:30:00+01:00,16,8,8,0,18834.80,-8
2024-05-24 17:30:00+01:00,21,6,15,0,18825.24,-15
2024-05-24 18:30:00+01:00,18,10,8,0,18827.43,-8
2024-05-24 19:30:00+01:00,21,7,14,0,18792.06,-14
2024-05-24 20:30:00+01:00,22,5,17,0,18809.05,-17
2024-05-28 14:30:00+01:00,23,4,19,0,18829.42,-19
2024-05-28 15:30:00+01:00,22,5,17,0,18858.23,-17
2024-05-28 16:30:00+01:00,27,5,22,0,18845.91,-22
2024-05-28 17:30:00+01:00,26,8,18,0,18856.60,-18
2024-05-28 18:30:00+01:00,22,14,8,0,18811.31,-8
2024-05-28 19:30:00+01:00,22,14,8,0,18811.56,-8
2024-05-28 20:30:00+01:00,21,16,5,0,18874.47,-5
2024-05-29 14:30:00+01:00,37,3,34,0,18787.63,-34
2024-05-29 15:30:00+01:00,45,2,43,0,18786.02,-43
2024-05-29 16:30:00+01:00,44,2,42,0,18788.48,-42
2024-05-29 17:30:00+01:00,41,1,40,0,18785.98,-40
2024-05-29 18:30:00+01:00,38,2,36,0,18777.04,-36
2024-05-29 19:30:00+01:00,34,3,31,0,18784.15,-31
2024-05-29 20:30:00+01:00,38,2,36,0,18731.55,-36
2024-05-30 14:30:00+01:00,29,2,27,0,18659.13,-27
2024-05-30 15:30:00+01:00,33,2,31,0,18610.45,-31
2024-05-30 16:30:00+01:00,26,2,24,0,18622.07,-24
2024-05-30 17:30:00+01:00,27,4,23,0,18651.69,-23
2024-05-30 18:30:00+01:00,26,4,22,0,18612.44,-22
2024-05-30 19:30:00+01:00,26,4,22,0,18568.35,-22
2024-05-30 20:30:00+01:00,34,4,30,0,18537.19,-30
2024-05-31 14:30:00+01:00,29,16,13,0,18370.73,-13
2024-05-31 15:30:00+01:00,32,15,17,0,18283.69,-17
2024-05-31 16:30:00+01:00,38,12,26,0,18204.61,-26
2024-05-31 17:30:00+01:00,33,14,19,0,18303.17,-19
2024-05-31 18:30:00+01:00,28,14,14,0,18267.96,-14
2024-05-31 19:30:00+01:00,22,15,7,0,18357.15,-7
2024-05-31 20:30:00+01:00,10,26,0,16,18540.82,16
2024-06-03 14:30:00+01:00,9,24,0,15,18652.86,15
2024-06-03 15:30:00+01:00,7,20,0,13,18568.36,13
2024-06-03 16:30:00+01:00,10,13,0,3,18457.89,3
2024-06-03 17:30:00+01:00,10,9,1,0,18479.81,-1
2024-06-03 18:30:00+01:00,8,11,0,3,18494.46,3
2024-06-03 19:30:00+01:00,5,12,0,7,18540.62,7
2024-06-03 20:30:00+01:00,5,15,0,10,18601.30,10
2024-06-04 14:30:00+01:00,0,17,0,17,18568.62,17
2024-06-04 15:30:00+01:00,2,19,0,17,18554.50,17
2024-06-04 16:30:00+01:00,2,21,0,19,18558.22,19
2024-06-04 17:30:00+01:00,3,22,0,19,18589.27,19
2024-06-04 18:30:00+01:00,1,30,0,29,18681.21,29
2024-06-04 19:30:00+01:00,2,17,0,15,18620.06,15
2024-06-04 20:30:00+01:00,10,13,0,3,18651.34,3
2024-06-05 14:30:00+01:00,5,13,0,8,18840.66,8
2024-06-05 15:30:00+01:00,2,21,0,19,18915.09,19
2024-06-05 16:30:00+01:00,1,42,0,41,18925.56,41
2024-06-05 17:30:00+01:00,1,41,0,40,18948.82,40
2024-06-05 18:30:00+01:00,2,40,0,38,18979.84,38
2024-06-05 19:30:00+01:00,2,35,0,33,18987.47,33
2024-06-05 20:30:00+01:00,3,31,0,28,19033.08,28
2024-06-06 14:30:00+01:00,4,36,0,32,19037.62,32
2024-06-06 15:30:00+01:00,1,40,0,39,19023.59,39
2024-06-06 16:30:00+01:00,2,47,0,45,19010.39,45
2024-06-06 17:30:00+01:00,3,46,0,43,19035.49,43
2024-06-06 18:30:00+01:00,4,31,0,27,19008.06,27
2024-06-06 19:30:00+01:00,4,36,0,32,19021.36,32
2024-06-06 20:30:00+01:00,4,30,0,26,19017.77,26
2024-06-07 14:30:00+01:00,5,20,0,15,19003.65,15
2024-06-07 15:30:00+01:00,11,14,0,3,19025.61,3
2024-06-07 16:30:00+01:00,11,18,0,7,19075.55,7
2024-06-07 17:30:00+01:00,7,13,0,6,19087.83,6
2024-06-07 18:30:00+01:00,11,10,1,0,19009.35,-1
2024-06-07 19:30:00+01:00,12,11,1,0,19011.27,-1
2024-06-07 20:30:00+01:00,16,5,11,0,19000.05,-11
2024-06-10 14:30:00+01:00,19,9,10,0,19001.56,-10
2024-06-10 15:30:00+01:00,16,10,6,0,19055.06,-6
2024-06-10 16:30:00+01:00,15,10,5,0,19071.07,-5
2024-06-10 17:30:00+01:00,20,8,12,0,19029.81,-12
2024-06-10 18:30:00+01:00,10,10,0,0,19016.33,0
2024-06-10 19:30:00+01:00,9,10,0,1,19078.53,1
2024-06-10 20:30:00+01:00,7,10,0,3,19075.72,3
2024-06-11 14:30:00+01:00,18,8,10,0,19054.95,-10
2024-06-11 15:30:00+01:00,16,11,5,0,19087.39,-5
2024-06-11 16:30:00+01:00,20,7,13,0,19065.42,-13
2024-06-11 17:30:00+01:00,16,8,8,0,19087.33,-8
2024-06-11 18:30:00+01:00,9,17,0,8,19178.25,8
2024-06-11 19:30:00+01:00,9,15,0,6,19160.69,6
2024-06-11 20:30:00+01:00,8,20,0,12,19210.55,12
2024-06-12 14:30:00+01:00,6,41,0,35,19510.46,35
2024-06-12 15:30:00+01:00,5,32,0,27,19501.67,27
2024-06-12 16:30:00+01:00,8,26,0,18,19469.94,18
2024-06-12 17:30:00+01:00,7,30,0,23,19493.61,23
2024-06-12 18:30:00+01:00,10,24,0,14,19495.82,14
2024-06-12 19:30:00+01:00,12,17,0,5,19433.70,5
2024-06-12 20:30:00+01:00,8,22,0,14,19465.85,14
2024-06-13 14:30:00+01:00,7,23,0,16,19544.35,16
2024-06-13 15:30:00+01:00,7,21,0,14,19550.84,14
2024-06-13 16:30:00+01:00,7,13,0,6,19479.98,6
2024-06-13 17:30:00+01:00,8,16,0,8,19545.85,8
2024-06-13 18:30:00+01:00,10,12,0,2,19559.51,2
2024-06-13 19:30:00+01:00,10,16,0,6,19575.89,6
2024-06-13 20:30:00+01:00,11,16,0,5,19572.77,5
2024-06-14 14:30:00+01:00,24,4,20,0,19606.37,-20
2024-06-14 15:30:00+01:00,21,6,15,0,19596.14,-15
2024-06-14 16:30:00+01:00,17,4,13,0,19588.08,-13
2024-06-14 17:30:00+01:00,17,6,11,0,19639.85,-11
2024-06-14 18:30:00+01:00,18,4,14,0,19635.81,-14
2024-06-14 19:30:00+01:00,12,7,5,0,19650.14,-5
2024-06-14 20:30:00+01:00,15,5,10,0,19663.34,-10
2024-06-17 14:30:00+01:00,16,12,4,0,19667.25,-4
2024-06-17 15:30:00+01:00,14,11,3,0,19729.45,-3
2024-06-17 16:30:00+01:00,12,22,0,10,19796.29,10
2024-06-17 17:30:00+01:00,15,21,0,6,19868.26,6
2024-06-17 18:30:00+01:00,9,27,0,18,19947.81,18
2024-06-17 19:30:00+01:00,10,27,0,17,19970.02,17
2024-06-17 20:30:00+01:00,8,25,0,17,19904.20,17
2024-06-18 14:30:00+01:00,10,32,0,22,19895.35,22
2024-06-18 15:30:00+01:00,7,30,0,23,19868.58,23
2024-06-18 16:30:00+01:00,8,31,0,23,19888.38,23
2024-06-18 17:30:00+01:00,12,29,0,17,19927.61,17
2024-06-18 18:30:00+01:00,11,29,0,18,19898.93,18
2024-06-18 19:30:00+01:00,13,28,0,15,19906.30,15
2024-06-18 20:30:00+01:00,13,29,0,16,19906.62,16
2024-06-20 14:30:00+01:00,8,26,0,18,19887.38,18
2024-06-20 15:30:00+01:00,6,23,0,17,19910.31,17
2024-06-20 16:30:00+01:00,7,12,0,5,19787.31,5
2024-06-20 17:30:00+01:00,8,11,0,3,19731.54,3
2024-06-20 18:30:00+01:00,9,7,2,0,19793.38,-2
2024-06-20 19:30:00+01:00,11,7,4,0,19748.86,-4
2024-06-20 20:30:00+01:00,10,10,0,0,19753.07,0
2024-06-21 14:30:00+01:00,16,14,2,0,19697.75,-2
2024-06-21 15:30:00+01:00,15,16,0,1,19728.63,1
2024-06-21 16:30:00+01:00,17,14,3,0,19773.45,-3
2024-06-21 17:30:00+01:00,19,16,3,0,19707.94,-3
2024-06-21 18:30:00+01:00,15,18,0,3,19728.44,3
2024-06-21 19:30:00+01:00,21,19,2,0,19723.56,-2
2024-06-21 20:30:00+01:00,14,17,0,3,19704.86,3
2024-06-24 14:30:00+01:00,15,20,0,5,19619.56,5
2024-06-24 15:30:00+01:00,15,20,0,5,19638.30,5
2024-06-24 16:30:00+01:00,14,21,0,7,19630.49,7
2024-06-24 17:30:00+01:00,11,13,0,2,19551.08,2
2024-06-24 18:30:00+01:00,16,13,3,0,19512.64,-3
2024-06-24 19:30:00+01:00,11,12,0,1,19562.69,1
2024-06-24 20:30:00+01:00,15,9,6,0,19477.43,-6
2024-06-25 14:30:00+01:00,10,13,0,3,19613.62,3
2024-06-25 15:30:00+01:00,10,15,0,5,19665.76,5
2024-06-25 16:30:00+01:00,12,13,0,1,19656.06,1
2024-06-25 17:30:00+01:00,13,10,3,0,19629.72,-3
2024-06-25 18:30:00+01:00,10,10,0,0,19695.03,0
2024-06-25 19:30:00+01:00,12,11,1,0,19711.89,-1
2024-06-25 20:30:00+01:00,13,10,3,0,19706.34,-3
2024-06-26 14:30:00+01:00,17,9,8,0,19695.54,-8
2024-06-26 15:30:00+01:00,19,9,10,0,19695.58,-10
2024-06-26 16:30:00+01:00,18,8,10,0,19741.73,-10
2024-06-26 17:30:00+01:00,16,14,2,0,19699.17,-2
2024-06-26 18:30:00+01:00,17,17,0,0,19709.86,0
2024-06-26 19:30:00+01:00,18,14,4,0,19700.39,-4
2024-06-26 20:30:00+01:00,13,22,0,9,19748.06,9
2024-06-27 14:30:00+01:00,16,17,0,1,19820.72,1
2024-06-27 15:30:00+01:00,16,14,2,0,19737.27,-2
2024-06-27 16:30:00+01:00,17,13,4,0,19774.57,-4
2024-06-27 17:30:00+01:00,14,16,0,2,19795.96,2
2024-06-27 18:30:00+01:00,17,12,5,0,19756.15,-5
2024-06-27 19:30:00+01:00,15,11,4,0,19795.21,-4
2024-06-27 20:30:00+01:00,18,14,4,0,19785.82,-4
2024-06-28 14:30:00+01:00,6,24,0,18,19968.47,18
2024-06-28 15:30:00+01:00,7,17,0,10,19854.33,10
2024-06-28 16:30:00+01:00,10,13,0,3,19822.61,3
2024-06-28 17:30:00+01:00,9,12,0,3,19803.88,3
2024-06-28 18:30:00+01:00,11,9,2,0,19769.04,-2
2024-06-28 19:30:00+01:00,9,12,0,3,19745.87,3
2024-06-28 20:30:00+01:00,8,12,0,4,19673.00,4
2024-07-01 14:30:00+01:00,18,6,12,0,19691.54,-12
2024-07-01 15:30:00+01:00,22,6,16,0,19710.22,-16
2024-07-01 16:30:00+01:00,22,9,13,0,19773.88,-13
2024-07-01 17:30:00+01:00,23,8,15,0,19765.33,-15
2024-07-01 18:30:00+01:00,18,7,11,0,19765.09,-11
2024-07-01 19:30:00+01:00,28,7,21,0,19765.53,-21
2024-07-01 20:30:00+01:00,22,6,16,0,19807.04,-16
2024-07-02 14:30:00+01:00,30,3,27,0,19816.98,-27
2024-07-02 15:30:00+01:00,15,6,9,0,19880.08,-9
2024-07-02 16:30:00+01:00,15,5,10,0,19864.99,-10
2024-07-02 17:30:00+01:00,14,6,8,0,19932.92,-8
2024-07-02 18:30:00+01:00,12,9,3,0,19980.19,-3
2024-07-02 19:30:00+01:00,9,14,0,5,19982.57,5
2024-07-02 20:30:00+01:00,6,18,0,12,20013.03,12
2024-07-03 14:30:00+01:00,8,30,0,22,20026.22,22
2024-07-03 15:30:00+01:00,8,34,0,26,20110.59,26
2024-07-03 16:30:00+01:00,5,31,0,26,20182.45,26
2024-07-05 14:30:00+01:00,6,23,0,17,20286.55,17
2024-07-05 15:30:00+01:00,5,30,0,25,20325.89,25
2024-07-05 16:30:00+01:00,3,37,0,34,20380.03,34
2024-07-05 17:30:00+01:00,6,35,0,29,20378.89,29
2024-07-05 18:30:00+01:00,3,35,0,32,20367.98,32
2024-07-05 19:30:00+01:00,4,34,0,30,20390.87,30
2024-07-05 20:30:00+01:00,1,36,0,35,20389.24,35
2024-07-08 14:30:00+01:00,4,29,0,25,20398.26,25
2024-07-08 15:30:00+01:00,8,27,0,19,20433.42,19
2024-07-08 16:30:00+01:00,9,18,0,9,20395.71,9
2024-07-08 17:30:00+01:00,9,22,0,13,20423.54,13
2024-07-08 18:30:00+01:00,10,25,0,15,20425.02,15
2024-07-08 19:30:00+01:00,6,17,0,11,20395.92,11
2024-07-08 20:30:00+01:00,11,20,0,9,20438.37,9
2024-07-09 14:30:00+01:00,10,19,0,9,20476.73,9
2024-07-09 15:30:00+01:00,15,17,0,2,20460.01,2
2024-07-09 16:30:00+01:00,18,14,4,0,20476.16,-4
2024-07-09 17:30:00+01:00,18,12,6,0,20408.91,-6
2024-07-09 18:30:00+01:00,17,14,3,0,20427.85,-3
2024-07-09 19:30:00+01:00,21,13,8,0,20438.05,-8
2024-07-09 20:30:00+01:00,25,9,16,0,20454.68,-16
2024-07-10 14:30:00+01:00,13,11,2,0,20546.19,-2
2024-07-10 15:30:00+01:00,15,13,2,0,20527.31,-2
2024-07-10 16:30:00+01:00,11,16,0,5,20584.71,5
2024-07-10 17:30:00+01:00,8,16,0,8,20625.52,8
2024-07-10 18:30:00+01:00,10,17,0,7,20639.41,7
2024-07-10 19:30:00+01:00,8,20,0,12,20643.12,12
2024-07-10 20:30:00+01:00,8,22,0,14,20673.42,14
2024-07-11 14:30:00+01:00,6,29,0,23,20472.47,23
2024-07-11 15:30:00+01:00,9,28,0,19,20318.31,19
2024-07-11 16:30:00+01:00,11,23,0,12,20294.01,12
2024-07-11 17:30:00+01:00,10,23,0,13,20267.75,13
2024-07-11 18:30:00+01:00,16,22,0,6,20200.29,6
2024-07-11 19:30:00+01:00,15,23,0,8,20223.12,8
2024-07-11 20:30:00+01:00,13,25,0,12,20217.06,12
2024-07-12 14:30:00+01:00,8,34,0,26,20343.10,26
2024-07-12 15:30:00+01:00,4,42,0,38,20443.57,38
2024-07-12 16:30:00+01:00,7,31,0,24,20380.95,24
2024-07-12 17:30:00+01:00,5,34,0,29,20456.94,29
2024-07-12 18:30:00+01:00,5,41,0,36,20491.64,36
2024-07-12 19:30:00+01:00,6,34,0,28,20468.82,28
2024-07-12 20:30:00+01:00,9,26,0,17,20332.22,17
2024-07-15 14:30:00+01:00,7,10,0,3,20478.00,3
2024-07-15 15:30:00+01:00,6,16,0,10,20529.22,10
2024-07-15 16:30:00+01:00,6,17,0,11,20456.23,11
2024-07-15 17:30:00+01:00,6,18,0,12,20402.98,12
2024-07-15 18:30:00+01:00,7,23,0,16,20394.09,16
2024-07-15 19:30:00+01:00,6,21,0,15,20416.95,15
2024-07-15 20:30:00+01:00,6,18,0,12,20392.84,12
2024-07-16 14:30:00+01:00,11,17,0,6,20319.51,6
2024-07-16 15:30:00+01:00,15,18,0,3,20355.94,3
2024-07-16 16:30:00+01:00,13,18,0,5,20285.96,5
2024-07-16 17:30:00+01:00,17,19,0,2,20311.67,2
2024-07-16 18:30:00+01:00,15,19,0,4,20332.46,4
2024-07-16 19:30:00+01:00,15,19,0,4,20374.58,4
2024-07-16 20:30:00+01:00,9,28,0,19,20397.21,19
2024-07-17 14:30:00+01:00,28,33,0,5,19936.07,5
2024-07-17 15:30:00+01:00,29,20,9,0,19929.84,-9
2024-07-17 16:30:00+01:00,30,19,11,0,19838.62,-11
2024-07-17 17:30:00+01:00,28,20,8,0,19851.13,-8
2024-07-17 18:30:00+01:00,24,18,6,0,19864.57,-6
2024-07-17 19:30:00+01:00,27,17,10,0,19860.57,-10
2024-07-17 20:30:00+01:00,27,19,8,0,19801.07,-8
2024-07-18 14:30:00+01:00,26,16,10,0,19857.09,-10
2024-07-18 15:30:00+01:00,34,16,18,0,19632.16,-18
2024-07-18 16:30:00+01:00,36,14,22,0,19644.95,-22
2024-07-18 17:30:00+01:00,32,13,19,0,19713.19,-19
2024-07-18 18:30:00+01:00,42,6,36,0,19663.96,-36
2024-07-18 19:30:00+01:00,45,5,40,0,19635.01,-40
2024-07-18 20:30:00+01:00,43,3,40,0,19706.31,-40
2024-07-19 14:30:00+01:00,39,1,38,0,19629.16,-38
2024-07-19 15:30:00+01:00,46,2,44,0,19571.16,-44
2024-07-19 16:30:00+01:00,30,1,29,0,19568.85,-29
2024-07-19 17:30:00+01:00,35,2,33,0,19511.60,-33
2024-07-19 18:30:00+01:00,44,1,43,0,19517.23,-43
2024-07-19 19:30:00+01:00,28,3,25,0,19588.10,-25
2024-07-19 20:30:00+01:00,30,3,27,0,19523.57,-27
2024-07-22 14:30:00+01:00,26,2,24,0,19775.85,-24
2024-07-22 15:30:00+01:00,23,3,20,0,19663.55,-20
2024-07-22 16:30:00+01:00,19,6,13,0,19713.19,-13
2024-07-22 17:30:00+01:00,14,6,8,0,19801.23,-8
2024-07-22 18:30:00+01:00,10,9,1,0,19842.88,-1
2024-07-22 19:30:00+01:00,5,16,0,11,19817.05,11
2024-07-22 20:30:00+01:00,7,14,0,7,19831.23,7
2024-07-23 14:30:00+01:00,6,16,0,10,19843.76,10
2024-07-23 15:30:00+01:00,7,24,0,17,19886.18,17
2024-07-23 16:30:00+01:00,6,7,0,1,19795.30,1
2024-07-23 17:30:00+01:00,7,12,0,5,19788.01,5
2024-07-23 18:30:00+01:00,6,12,0,6,19786.18,6
2024-07-23 19:30:00+01:00,6,9,0,3,19814.71,3
2024-07-23 20:30:00+01:00,7,9,0,2,19753.89,2
2024-07-24 14:30:00+01:00,23,6,17,0,19324.24,-17
2024-07-24 15:30:00+01:00,20,3,17,0,19234.36,-17
2024-07-24 16:30:00+01:00,30,4,26,0,19167.07,-26
2024-07-24 17:30:00+01:00,41,3,38,0,19187.10,-38
2024-07-24 18:30:00+01:00,41,2,39,0,19127.20,-39
2024-07-24 19:30:00+01:00,46,2,44,0,19053.83,-44
2024-07-24 20:30:00+01:00,47,4,43,0,19037.09,-43
2024-07-25 14:30:00+01:00,46,17,29,0,18924.04,-29
2024-07-25 15:30:00+01:00,42,11,31,0,19044.00,-31
2024-07-25 16:30:00+01:00,24,13,11,0,19179.45,-11
2024-07-25 17:30:00+01:00,27,12,15,0,19106.67,-15
2024-07-25 18:30:00+01:00,31,7,24,0,19061.69,-24
2024-07-25 19:30:00+01:00,34,8,26,0,19056.91,-26
2024-07-25 20:30:00+01:00,42,6,36,0,18828.61,-36
2024-07-26 14:30:00+01:00,15,11,4,0,18995.64,-4
2024-07-26 15:30:00+01:00,12,7,5,0,18960.37,-5
2024-07-26 16:30:00+01:00,9,7,2,0,19081.00,-2
2024-07-26 17:30:00+01:00,8,10,0,2,19137.51,2
2024-07-26 18:30:00+01:00,8,6,2,0,19029.83,-2
2024-07-26 19:30:00+01:00,7,8,0,1,19029.82,1
2024-07-26 20:30:00+01:00,5,12,0,7,19023.92,7
2024-07-29 14:30:00+01:00,9,7,2,0,19145.16,-2
2024-07-29 15:30:00+01:00,7,8,0,1,19042.55,1
2024-07-29 16:30:00+01:00,7,6,1,0,19153.77,-1
2024-07-29 17:30:00+01:00,6,7,0,1,19120.81,1
2024-07-29 18:30:00+01:00,7,9,0,2,19072.88,2
2024-07-29 19:30:00+01:00,6,12,0,6,19092.01,6
2024-07-29 20:30:00+01:00,4,21,0,17,19058.79,17
2024-07-30 14:30:00+01:00,3,14,0,11,19024.77,11
2024-07-30 15:30:00+01:00,5,15,0,10,18884.00,10
2024-07-30 16:30:00+01:00,18,13,5,0,18793.62,-5
2024-07-30 17:30:00+01:00,24,10,14,0,18763.78,-14
2024-07-30 18:30:00+01:00,16,15,1,0,18829.10,-1
2024-07-30 19:30:00+01:00,17,15,2,0,18791.25,-2
2024-07-30 20:30:00+01:00,16,19,0,3,18789.54,3
2024-07-31 14:30:00+01:00,4,24,0,20,19286.71,20
2024-07-31 15:30:00+01:00,4,24,0,20,19341.32,20
2024-07-31 16:30:00+01:00,6,13,0,7,19303.57,7
2024-07-31 17:30:00+01:00,5,17,0,12,19296.44,12
2024-07-31 18:30:00+01:00,3,18,0,15,19329.34,15
2024-07-31 19:30:00+01:00,5,13,0,8,19294.92,8
2024-07-31 20:30:00+01:00,4,10,0,6,19360.57,6
2024-08-01 14:30:00+01:00,6,7,0,1,19315.05,1
2024-08-01 15:30:00+01:00,8,9,0,1,19127.85,1
2024-08-01 16:30:00+01:00,9,7,2,0,19018.74,-2
2024-08-01 17:30:00+01:00,10,9,1,0,18882.78,-1
2024-08-01 18:30:00+01:00,13,7,6,0,18784.04,-6
2024-08-01 19:30:00+01:00,12,6,6,0,18840.01,-6
2024-08-01 20:30:00+01:00,13,9,4,0,18882.06,-4
2024-08-02 14:30:00+01:00,57,5,52,0,18373.39,-52
2024-08-02 15:30:00+01:00,64,3,61,0,18359.69,-61
2024-08-02 16:30:00+01:00,49,5,44,0,18470.98,-44
2024-08-02 17:30:00+01:00,54,4,50,0,18362.47,-50
2024-08-02 18:30:00+01:00,50,5,45,0,18427.58,-45
2024-08-02 19:30:00+01:00,47,6,41,0,18426.36,-41
2024-08-02 20:30:00+01:00,47,6,41,0,18436.21,-41
2024-08-05 14:30:00+01:00,65,0,65,0,17755.60,-65
2024-08-05 15:30:00+01:00,47,2,45,0,17993.30,-45
2024-08-05 16:30:00+01:00,24,2,22,0,18166.82,-22
2024-08-05 17:30:00+01:00,25,2,23,0,17982.25,-23
2024-08-05 18:30:00+01:00,24,1,23,0,17926.01,-23
2024-08-05 19:30:00+01:00,34,1,33,0,17865.18,-33
2024-08-05 20:30:00+01:00,36,1,35,0,17894.37,-35
2024-08-06 14:30:00+01:00,11,4,7,0,18064.30,-7
2024-08-06 15:30:00+01:00,7,3,4,0,18084.22,-4
2024-08-06 16:30:00+01:00,4,3,1,0,18223.92,-1
2024-08-06 17:30:00+01:00,7,4,3,0,18308.02,-3
2024-08-06 18:30:00+01:00,4,3,1,0,18344.38,-1
2024-08-06 19:30:00+01:00,12,3,9,0,18229.94,-9
2024-08-06 20:30:00+01:00,14,1,13,0,18071.69,-13
2024-08-07 14:30:00+01:00,1,30,0,29,18328.88,29
2024-08-07 15:30:00+01:00,0,19,0,19,18360.45,19
2024-08-07 16:30:00+01:00,1,8,0,7,18274.23,7
2024-08-07 17:30:00+01:00,1,9,0,8,18094.79,8
2024-08-07 18:30:00+01:00,1,7,0,6,17976.15,6
2024-08-07 19:30:00+01:00,2,10,0,8,17985.06,8
2024-08-07 20:30:00+01:00,2,3,0,1,17864.78,1
2024-08-08 14:30:00+01:00,2,10,0,8,18270.69,8
2024-08-08 15:30:00+01:00,4,8,0,4,18286.27,4
2024-08-08 16:30:00+01:00,4,5,0,1,18331.81,1
2024-08-08 17:30:00+01:00,3,6,0,3,18385.78,3
2024-08-08 18:30:00+01:00,2,5,0,3,18405.18,3
2024-08-08 19:30:00+01:00,3,7,0,4,18339.17,4
2024-08-08 20:30:00+01:00,2,12,0,10,18413.37,10
2024-08-09 14:30:00+01:00,6,4,2,0,18400.43,-2
2024-08-09 15:30:00+01:00,10,4,6,0,18414.45,-6
2024-08-09 16:30:00+01:00,8,4,4,0,18383.41,-4
2024-08-09 17:30:00+01:00,3,21,0,18,18543.78,18
2024-08-09 18:30:00+01:00,3,31,0,28,18491.62,28
2024-08-09 19:30:00+01:00,2,30,0,28,18508.86,28
2024-08-09 20:30:00+01:00,2,43,0,41,18513.90,41
2024-08-12 14:30:00+01:00,4,18,0,14,18592.89,14
2024-08-12 15:30:00+01:00,7,12,0,5,18529.84,5
2024-08-12 16:30:00+01:00,4,15,0,11,18595.67,11
2024-08-12 17:30:00+01:00,7,11,0,4,18555.57,4
2024-08-12 18:30:00+01:00,8,5,3,0,18527.08,-3
2024-08-12 19:30:00+01:00,4,9,0,5,18523.37,5
2024-08-12 20:30:00+01:00,8,7,1,0,18543.48,-1
2024-08-13 14:30:00+01:00,4,23,0,19,18804.00,19
2024-08-13 15:30:00+01:00,5,29,0,24,18869.17,24
2024-08-13 16:30:00+01:00,3,37,0,34,18913.52,34
2024-08-13 17:30:00+01:00,2,26,0,24,18967.78,24
2024-08-13 18:30:00+01:00,0,32,0,32,18969.07,32
2024-08-13 19:30:00+01:00,1,35,0,34,18962.14,34
2024-08-13 20:30:00+01:00,0,31,0,31,19006.21,31
2024-08-14 14:30:00+01:00,3,25,0,22,18917.23,22
2024-08-14 15:30:00+01:00,2,37,0,35,19011.09,35
2024-08-14 16:30:00+01:00,3,30,0,27,18979.51,27
2024-08-14 17:30:00+01:00,3,38,0,35,18987.97,35
2024-08-14 18:30:00+01:00,2,44,0,42,18992.74,42
2024-08-14 19:30:00+01:00,2,42,0,40,18961.52,40
2024-08-14 20:30:00+01:00,1,38,0,37,19021.32,37
2024-08-15 14:30:00+01:00,0,54,0,54,19377.59,54
2024-08-15 15:30:00+01:00,0,51,0,51,19403.25,51
2024-08-15 16:30:00+01:00,0,48,0,48,19464.60,48
2024-08-15 17:30:00+01:00,1,40,0,39,19443.32,39
2024-08-15 18:30:00+01:00,0,40,0,40,19482.92,40
2024-08-15 19:30:00+01:00,1,41,0,40,19482.99,40
2024-08-15 20:30:00+01:00,2,39,0,37,19488.71,37
2024-08-16 14:30:00+01:00,4,45,0,41,19478.49,41
2024-08-16 15:30:00+01:00,1,39,0,38,19439.19,38
2024-08-16 16:30:00+01:00,1,45,0,44,19521.14,44
2024-08-16 17:30:00+01:00,1,49,0,48,19543.37,48
2024-08-16 18:30:00+01:00,1,48,0,47,19518.47,47
2024-08-16 19:30:00+01:00,1,49,0,48,19508.00,48
2024-08-16 20:30:00+01:00,0,46,0,46,19508.81,46
2024-08-19 14:30:00+01:00,2,27,0,25,19521.91,25
2024-08-19 15:30:00+01:00,3,27,0,24,19565.88,24
2024-08-19 16:30:00+01:00,8,26,0,18,19571.74,18
2024-08-19 17:30:00+01:00,5,26,0,21,19602.54,21
2024-08-19 18:30:00+01:00,4,22,0,18,19648.69,18
2024-08-19 19:30:00+01:00,5,24,0,19,19690.42,19
2024-08-19 20:30:00+01:00,2,32,0,30,19763.91,30
2024-08-20 14:30:00+01:00,0,36,0,36,19732.53,36
2024-08-20 15:30:00+01:00,1,28,0,27,19706.04,27
2024-08-20 16:30:00+01:00,0,29,0,29,19719.53,29
2024-08-20 17:30:00+01:00,1,23,0,22,19698.07,22
2024-08-20 18:30:00+01:00,1,29,0,28,19759.05,28
2024-08-20 19:30:00+01:00,2,26,0,24,19733.12,24
2024-08-20 20:30:00+01:00,4,24,0,20,19716.68,20
2024-08-21 14:30:00+01:00,4,27,0,23,19791.93,23
2024-08-21 15:30:00+01:00,6,24,0,18,19778.29,18
2024-08-21 16:30:00+01:00,5,24,0,19,19750.35,19
2024-08-21 17:30:00+01:00,7,23,0,16,19769.79,16
2024-08-21 18:30:00+01:00,4,25,0,21,19839.56,21
2024-08-21 19:30:00+01:00,5,14,0,9,19781.59,9
2024-08-21 20:30:00+01:00,5,14,0,9,19822.58,9
2024-08-22 14:30:00+01:00,9,22,0,13,19830.27,13
2024-08-22 15:30:00+01:00,11,11,0,0,19725.07,0
2024-08-22 16:30:00+01:00,8,16,0,8,19727.24,8
2024-08-22 17:30:00+01:00,12,10,2,0,19628.52,-2
2024-08-22 18:30:00+01:00,16,9,7,0,19574.72,-7
2024-08-22 19:30:00+01:00,21,9,12,0,19496.33,-12
2024-08-22 20:30:00+01:00,19,9,10,0,19495.25,-10
2024-08-23 14:30:00+01:00,9,13,0,4,19807.42,4
2024-08-23 15:30:00+01:00,10,12,0,2,19693.43,2
2024-08-23 16:30:00+01:00,16,10,6,0,19582.63,-6
2024-08-23 17:30:00+01:00,15,10,5,0,19649.42,-5
2024-08-23 18:30:00+01:00,15,8,7,0,19674.82,-7
2024-08-23 19:30:00+01:00,10,9,1,0,19724.05,-1
2024-08-23 20:30:00+01:00,11,9,2,0,19721.09,-2
2024-08-26 14:30:00+01:00,10,17,0,7,19541.53,7
2024-08-26 15:30:00+01:00,8,16,0,8,19537.06,8
2024-08-26 16:30:00+01:00,7,14,0,7,19540.26,7
2024-08-26 17:30:00+01:00,8,25,0,17,19523.00,17
2024-08-26 18:30:00+01:00,6,16,0,10,19504.77,10
2024-08-26 19:30:00+01:00,4,16,0,12,19515.64,12
2024-08-26 20:30:00+01:00,5,16,0,11,19517.67,11
2024-08-27 14:30:00+01:00,24,10,14,0,19553.11,-14
2024-08-27 15:30:00+01:00,22,11,11,0,19563.68,-11
2024-08-27 16:30:00+01:00,15,18,0,3,19551.85,3
2024-08-27 17:30:00+01:00,15,17,0,2,19597.59,2
2024-08-27 18:30:00+01:00,13,16,0,3,19592.47,3
2024-08-27 19:30:00+01:00,19,13,6,0,19578.29,-6
2024-08-27 20:30:00+01:00,16,15,1,0,19584.60,-1
2024-08-28 14:30:00+01:00,17,10,7,0,19511.05,-7
2024-08-28 15:30:00+01:00,27,5,22,0,19319.86,-22
2024-08-28 16:30:00+01:00,29,3,26,0,19330.20,-26
2024-08-28 17:30:00+01:00,25,2,23,0,19362.63,-23
2024-08-28 18:30:00+01:00,26,2,24,0,19263.52,-24
2024-08-28 19:30:00+01:00,17,4,13,0,19388.52,-13
2024-08-28 20:30:00+01:00,20,3,17,0,19351.25,-17
2024-08-29 14:30:00+01:00,7,6,1,0,19532.79,-1
2024-08-29 15:30:00+01:00,6,7,0,1,19563.16,1
2024-08-29 16:30:00+01:00,8,10,0,2,19601.88,2
2024-08-29 17:30:00+01:00,9,8,1,0,19552.89,-1
2024-08-29 18:30:00+01:00,9,5,4,0,19439.96,-4
2024-08-29 19:30:00+01:00,11,3,8,0,19341.08,-8
2024-08-29 20:30:00+01:00,12,2,10,0,19328.30,-10
2024-08-30 14:30:00+01:00,7,5,2,0,19494.90,-2
2024-08-30 15:30:00+01:00,6,7,0,1,19416.13,1
2024-08-30 16:30:00+01:00,10,6,4,0,19370.73,-4
2024-08-30 17:30:00+01:00,9,6,3,0,19415.38,-3
2024-08-30 18:30:00+01:00,6,11,0,5,19426.36,5
2024-08-30 19:30:00+01:00,7,11,0,4,19507.78,4
2024-08-30 20:30:00+01:00,5,14,0,9,19571.96,9
2024-09-03 14:30:00+01:00,13,4,9,0,19270.78,-9
2024-09-03 15:30:00+01:00,19,9,10,0,19150.62,-10
2024-09-03 16:30:00+01:00,29,8,21,0,19119.00,-21
2024-09-03 17:30:00+01:00,30,9,21,0,19124.29,-21
2024-09-03 18:30:00+01:00,32,8,24,0,18991.73,-24
2024-09-03 19:30:00+01:00,31,7,24,0,18985.99,-24
2024-09-03 20:30:00+01:00,32,6,26,0,18959.76,-26
2024-09-04 14:30:00+01:00,42,7,35,0,18940.16,-35
2024-09-04 15:30:00+01:00,33,10,23,0,18971.62,-23
2024-09-04 16:30:00+01:00,31,8,23,0,18998.56,-23
2024-09-04 17:30:00+01:00,35,7,28,0,18977.33,-28
2024-09-04 18:30:00+01:00,35,7,28,0,18967.59,-28
2024-09-04 19:30:00+01:00,46,7,39,0,18919.45,-39
2024-09-04 20:30:00+01:00,49,8,41,0,18918.62,-41
2024-09-05 14:30:00+01:00,41,4,37,0,19064.26,-37
2024-09-05 15:30:00+01:00,56,1,55,0,18832.86,-55
2024-09-05 16:30:00+01:00,38,1,37,0,18900.12,-37
2024-09-05 17:30:00+01:00,39,1,38,0,18852.85,-38
2024-09-05 18:30:00+01:00,15,2,13,0,18949.01,-13
2024-09-05 19:30:00+01:00,19,2,17,0,18922.30,-17
2024-09-05 20:30:00+01:00,16,4,12,0,18927.85,-12
2024-09-06 14:30:00+01:00,31,0,31,0,18617.04,-31
2024-09-06 15:30:00+01:00,43,0,43,0,18471.63,-43
2024-09-06 16:30:00+01:00,49,0,49,0,18418.39,-49
2024-09-06 17:30:00+01:00,39,0,39,0,18462.10,-39
2024-09-06 18:30:00+01:00,39,0,39,0,18423.98,-39
2024-09-06 19:30:00+01:00,28,0,28,0,18481.55,-28
2024-09-06 20:30:00+01:00,34,1,33,0,18421.30,-33
2024-09-09 14:30:00+01:00,18,5,13,0,18588.92,-13
2024-09-09 15:30:00+01:00,10,7,3,0,18532.98,-3
2024-09-09 16:30:00+01:00,9,10,0,1,18643.57,1
2024-09-09 17:30:00+01:00,7,10,0,3,18680.70,3
2024-09-09 18:30:00+01:00,16,5,11,0,18565.74,-11
2024-09-09 19:30:00+01:00,11,6,5,0,18611.08,-5
2024-09-09 20:30:00+01:00,12,5,7,0,18664.13,-7
2024-09-10 14:30:00+01:00,9,11,0,2,18754.32,2
2024-09-10 15:30:00+01:00,3,22,0,19,18746.16,19
2024-09-10 16:30:00+01:00,4,12,0,8,18614.19,8
2024-09-10 17:30:00+01:00,6,15,0,9,18717.87,9
2024-09-10 18:30:00+01:00,3,17,0,14,18796.30,14
2024-09-10 19:30:00+01:00,4,19,0,15,18828.33,15
2024-09-10 20:30:00+01:00,1,21,0,20,18835.70,20
2024-09-11 14:30:00+01:00,13,10,3,0,18636.15,-3
2024-09-11 15:30:00+01:00,9,11,0,2,18664.69,2
2024-09-11 16:30:00+01:00,8,12,0,4,18883.90,4
2024-09-11 17:30:00+01:00,4,12,0,8,18959.33,8
2024-09-11 18:30:00+01:00,3,18,0,15,19093.09,15
2024-09-11 19:30:00+01:00,2,20,0,18,19172.45,18
2024-09-11 20:30:00+01:00,2,22,0,20,19232.49,20
2024-09-12 14:30:00+01:00,3,25,0,22,19316.18,22
2024-09-12 15:30:00+01:00,5,24,0,19,19270.99,19
2024-09-12 16:30:00+01:00,4,34,0,30,19296.15,30
2024-09-12 17:30:00+01:00,4,33,0,29,19383.96,29
2024-09-12 18:30:00+01:00,1,33,0,32,19446.78,32
2024-09-12 19:30:00+01:00,2,27,0,25,19422.07,25
2024-09-12 20:30:00+01:00,2,28,0,26,19425.24,26
2024-09-13 14:30:00+01:00,2,69,0,67,19447.72,67
2024-09-13 15:30:00+01:00,2,66,0,64,19502.66,64
2024-09-13 16:30:00+01:00,3,54,0,51,19481.03,51
2024-09-13 17:30:00+01:00,3,53,0,50,19543.60,50
2024-09-13 18:30:00+01:00,3,37,0,34,19497.78,34
2024-09-13 19:30:00+01:00,3,33,0,30,19510.13,30
2024-09-13 20:30:00+01:00,5,31,0,26,19512.74,26
2024-09-16 14:30:00+01:00,4,31,0,27,19373.52,27
2024-09-16 15:30:00+01:00,3,26,0,23,19369.78,23
2024-09-16 16:30:00+01:00,7,25,0,18,19347.91,18
2024-09-16 17:30:00+01:00,7,19,0,12,19369.88,12
2024-09-16 18:30:00+01:00,6,20,0,14,19419.47,14
2024-09-16 19:30:00+01:00,7,18,0,11,19403.70,11
2024-09-16 20:30:00+01:00,5,17,0,12,19425.21,12
2024-09-17 14:30:00+01:00,7,32,0,25,19554.10,25
2024-09-17 15:30:00+01:00,10,26,0,16,19521.21,16
2024-09-17 16:30:00+01:00,13,18,0,5,19444.70,5
2024-09-17 17:30:00+01:00,13,12,1,0,19432.30,-1
2024-09-17 18:30:00+01:00,15,20,0,5,19413.47,5
2024-09-17 19:30:00+01:00,15,15,0,0,19401.31,0
2024-09-17 20:30:00+01:00,14,17,0,3,19434.01,3
2024-09-18 14:30:00+01:00,11,16,0,5,19449.97,5
2024-09-18 15:30:00+01:00,15,16,0,1,19418.55,1
2024-09-18 16:30:00+01:00,12,16,0,4,19424.15,4
2024-09-18 17:30:00+01:00,12,17,0,5,19457.42,5
2024-09-18 18:30:00+01:00,14,21,0,7,19562.79,7
2024-09-18 19:30:00+01:00,11,19,0,8,19499.86,8
2024-09-18 20:30:00+01:00,15,5,10,0,19346.34,-10
2024-09-19 14:30:00+01:00,4,10,0,6,19880.87,6
2024-09-19 15:30:00+01:00,6,14,0,8,19888.58,8
2024-09-19 16:30:00+01:00,5,21,0,16,19912.88,16
2024-09-19 17:30:00+01:00,4,26,0,22,19914.77,22
2024-09-19 18:30:00+01:00,4,27,0,23,19906.19,23
2024-09-19 19:30:00+01:00,5,16,0,11,19860.44,11
2024-09-19 20:30:00+01:00,4,16,0,12,19838.94,12
2024-09-20 14:30:00+01:00,4,12,0,8,19767.21,8
2024-09-20 15:30:00+01:00,4,9,0,5,19677.91,5
2024-09-20 16:30:00+01:00,5,11,0,6,19784.19,6
2024-09-20 17:30:00+01:00,4,11,0,7,19770.20,7
2024-09-20 18:30:00+01:00,8,8,0,0,19725.16,0
2024-09-20 19:30:00+01:00,7,9,0,2,19806.27,2
2024-09-20 20:30:00+01:00,4,20,0,16,19794.18,16
2024-09-23 14:30:00+01:00,18,9,9,0,19870.42,-9
2024-09-23 15:30:00+01:00,17,13,4,0,19859.52,-4
2024-09-23 16:30:00+01:00,22,10,12,0,19839.07,-12
2024-09-23 17:30:00+01:00,22,8,14,0,19815.76,-14
2024-09-23 18:30:00+01:00,18,8,10,0,19842.11,-10
2024-09-23 19:30:00+01:00,17,12,5,0,19849.86,-5
2024-09-23 20:30:00+01:00,17,13,4,0,19851.65,-4
2024-09-24 14:30:00+01:00,8,15,0,7,19769.31,7
2024-09-24 15:30:00+01:00,4,31,0,27,19888.92,27
2024-09-24 16:30:00+01:00,6,29,0,23,19959.93,23
2024-09-24 17:30:00+01:00,6,32,0,26,19947.18,26
2024-09-24 18:30:00+01:00,5,31,0,26,19921.21,26
2024-09-24 19:30:00+01:00,8,29,0,21,19927.86,21
2024-09-24 20:30:00+01:00,7,25,0,18,19945.37,18
2024-09-25 14:30:00+01:00,9,22,0,13,20003.68,13
2024-09-25 15:30:00+01:00,14,20,0,6,19980.32,6
2024-09-25 16:30:00+01:00,15,23,0,8,19986.49,8
2024-09-25 17:30:00+01:00,14,17,0,3,19961.36,3
,,,,,,
,,,,,,
,,,,,,
,,,,,,
,,,,,,
,,,,,,
,,,,,,
,,,,,,
,,,,,,
,,,,,,
,,,,,,
,,,,,,
,,,,,,
,,,,,,
,,,,,,
,,,,,,
,,,,,,
,,,,,,
,,,,,,
,,,,,,
,,,,,,
,,,,,,
,,,,,,
,,,,,,
,,,,,,
,,,,,,
,,,,,,
,,,,,,
,,,,,,
,,,,,,
,,,,,,
,,,,,,
,,,,,,
,,,,,,
,,,,,,
,,,,,,
,,,,,,
,,,,,,
,,,,,,
,,,,,,
,,,,,,
,,,,,,
,,,,,,
,,,,,,
,,,,,,
,,,,,,
,,,,,,
,,,,,,
,,,,,,
,,,,,,
