Datetime,Buy_Count,Sell_Count,B_S,Position,Close
2021-11-02 13:30:00+00:00,0,0,0,No Signal,15959.2177734375
2021-11-02 14:30:00+00:00,0,0,0,No Signal,15965.5283203125
2021-11-02 15:30:00+00:00,0,0,0,No Signal,15951.662109375
2021-11-02 16:30:00+00:00,0,0,0,No Signal,15945.3447265625
2021-11-02 17:30:00+00:00,0,0,0,No Signal,15931.26953125
2021-11-02 18:30:00+00:00,0,0,0,No Signal,15964.716796875
2021-11-02 19:30:00+00:00,0,0,0,No Signal,15973.69921875
2021-11-03 13:30:00+00:00,0,0,0,No Signal,15969.1875
2021-11-03 14:30:00+00:00,0,0,0,No Signal,15974.48046875
2021-11-03 15:30:00+00:00,0,0,0,No Signal,15990.8984375
2021-11-03 16:30:00+00:00,0,0,0,No Signal,15990.546875
2021-11-03 17:30:00+00:00,0,0,0,No Signal,16026.0068359375
2021-11-03 18:30:00+00:00,0,0,0,No Signal,16110.4384765625
2021-11-03 19:30:00+00:00,0,33,-33,Short,16143.1337890625
2021-11-04 13:30:00+00:00,1,37,-36,No Signal,16306.8037109375
2021-11-04 14:30:00+00:00,3,25,-22,No Signal,16260.1298828125
2021-11-04 15:30:00+00:00,3,33,-30,No Signal,16314.11328125
2021-11-04 16:30:00+00:00,4,36,-32,No Signal,16326.505859375
2021-11-04 17:30:00+00:00,6,35,-29,No Signal,16369.1416015625
2021-11-04 18:30:00+00:00,5,29,-24,No Signal,16340.0771484375
2021-11-04 19:30:00+00:00,4,30,-26,No Signal,16347.3095703125
2021-11-05 13:30:00+00:00,7,49,-42,No Signal,16427.970703125
2021-11-05 14:30:00+00:00,8,42,-34,No Signal,16417.908203125
2021-11-05 15:30:00+00:00,8,41,-33,No Signal,16427.62109375
2021-11-05 16:30:00+00:00,10,32,-22,No Signal,16304.6103515625
2021-11-05 17:30:00+00:00,6,34,-28,No Signal,16370.9072265625
2021-11-05 18:30:00+00:00,8,27,-19,No Signal,16353.1083984375
2021-11-05 19:30:00+00:00,7,25,-18,No Signal,16354.6982421875
2021-11-08 14:30:00+00:00,12,16,-4,No Signal,16351.0224609375
2021-11-08 15:30:00+00:00,11,24,-13,No Signal,16370.7568359375
2021-11-08 16:30:00+00:00,16,21,-5,No Signal,16336.015625
2021-11-08 17:30:00+00:00,12,19,-7,No Signal,16370.6650390625
2021-11-08 18:30:00+00:00,9,16,-7,No Signal,16352.046875
2021-11-08 19:30:00+00:00,10,16,-6,No Signal,16359.4091796875
2021-11-08 20:30:00+00:00,12,15,-3,No Signal,16334.9404296875
2021-11-09 14:30:00+00:00,12,8,4,No Signal,16248.27734375
2021-11-09 15:30:00+00:00,16,10,6,No Signal,16244.322265625
2021-11-09 16:30:00+00:00,14,10,4,No Signal,16215.693359375
2021-11-09 17:30:00+00:00,12,15,-3,No Signal,16200.2861328125
2021-11-09 18:30:00+00:00,14,12,2,No Signal,16219.1767578125
2021-11-09 19:30:00+00:00,11,10,1,No Signal,16201.1220703125
2021-11-09 20:30:00+00:00,12,11,1,No Signal,16222.0048828125
2021-11-10 14:30:00+00:00,12,11,1,No Signal,16187.7490234375
2021-11-10 15:30:00+00:00,18,15,3,No Signal,16156.1513671875
2021-11-10 16:30:00+00:00,17,17,0,No Signal,16129.982421875
2021-11-10 17:30:00+00:00,27,13,14,Long,16061.6767578125
2021-11-10 18:30:00+00:00,35,12,23,No Signal,15944.99609375
2021-11-10 19:30:00+00:00,33,8,25,No Signal,15988.8212890625
2021-11-10 20:30:00+00:00,35,6,29,No Signal,15984.09375
2021-11-11 14:30:00+00:00,17,5,12,No Signal,16058.298828125
2021-11-11 15:30:00+00:00,19,8,11,No Signal,16079.4794921875
2021-11-11 16:30:00+00:00,21,6,15,No Signal,16047.744140625
2021-11-11 17:30:00+00:00,21,7,14,No Signal,16050.947265625
2021-11-11 18:30:00+00:00,19,8,11,No Signal,16067.375
2021-11-11 19:30:00+00:00,24,8,16,No Signal,16038.3994140625
2021-11-11 20:30:00+00:00,26,6,20,No Signal,16031.52734375
2021-11-12 14:30:00+00:00,21,8,13,No Signal,16070.6220703125
2021-11-12 15:30:00+00:00,10,15,-5,No Signal,16186.3671875
2021-11-12 16:30:00+00:00,10,17,-7,No Signal,16194.830078125
2021-11-12 17:30:00+00:00,10,26,-16,Short,16182.8603515625
2021-11-12 18:30:00+00:00,11,38,-27,No Signal,16177.75390625
2021-11-12 19:30:00+00:00,9,40,-31,No Signal,16202.29296875
2021-11-12 20:30:00+00:00,7,38,-31,No Signal,16200.828125
2021-11-15 14:30:00+00:00,6,28,-22,No Signal,16168.9189453125
2021-11-15 15:30:00+00:00,6,25,-19,No Signal,16170.6552734375
2021-11-15 16:30:00+00:00,5,14,-9,No Signal,16111.7275390625
2021-11-15 17:30:00+00:00,5,23,-18,No Signal,16152.3330078125
2021-11-15 18:30:00+00:00,5,19,-14,No Signal,16139.7294921875
2021-11-15 19:30:00+00:00,5,25,-20,No Signal,16198.0732421875
2021-11-15 20:30:00+00:00,4,27,-23,No Signal,16192.8203125
2021-11-16 14:30:00+00:00,4,22,-18,No Signal,16208.943359375
2021-11-16 15:30:00+00:00,6,19,-13,No Signal,16301.5986328125
2021-11-16 16:30:00+00:00,5,16,-11,No Signal,16296.595703125
2021-11-16 17:30:00+00:00,7,16,-9,No Signal,16296.853515625
2021-11-16 18:30:00+00:00,6,15,-9,No Signal,16319.1416015625
2021-11-16 19:30:00+00:00,6,14,-8,No Signal,16310.52734375
2021-11-16 20:30:00+00:00,6,17,-11,No Signal,16308.2783203125
2021-11-17 14:30:00+00:00,10,14,-4,No Signal,16318.0205078125
2021-11-17 15:30:00+00:00,10,14,-4,No Signal,16357.111328125
2021-11-17 16:30:00+00:00,10,20,-10,No Signal,16314.1455078125
2021-11-17 17:30:00+00:00,10,23,-13,No Signal,16329.8388671875
2021-11-17 18:30:00+00:00,11,21,-10,No Signal,16339.0322265625
2021-11-17 19:30:00+00:00,8,17,-9,No Signal,16314.90234375
2021-11-17 20:30:00+00:00,10,14,-4,No Signal,16307.322265625
2021-11-18 14:30:00+00:00,19,9,10,Long,16335.3115234375
2021-11-18 15:30:00+00:00,20,11,9,No Signal,16390.73828125
2021-11-18 16:30:00+00:00,13,14,-1,No Signal,16488.943359375
2021-11-18 17:30:00+00:00,15,14,1,No Signal,16442.70703125
2021-11-18 18:30:00+00:00,15,6,9,No Signal,16427.4921875
2021-11-18 19:30:00+00:00,14,7,7,No Signal,16473.830078125
2021-11-18 20:30:00+00:00,12,8,4,No Signal,16483.958984375
2021-11-19 14:30:00+00:00,15,15,0,No Signal,16555.0078125
2021-11-19 15:30:00+00:00,13,15,-2,No Signal,16606.068359375
2021-11-19 16:30:00+00:00,13,23,-10,Short,16609.21875
2021-11-19 17:30:00+00:00,18,16,2,No Signal,16559.1953125
2021-11-19 18:30:00+00:00,16,16,0,No Signal,16580.970703125
2021-11-19 19:30:00+00:00,19,15,4,No Signal,16578.416015625
2021-11-19 20:30:00+00:00,19,16,3,No Signal,16574.4609375
2021-11-22 14:30:00+00:00,14,33,-19,No Signal,16738.431640625
2021-11-22 15:30:00+00:00,26,22,4,No Signal,16612.072265625
2021-11-22 16:30:00+00:00,24,14,10,Long,16509.091796875
2021-11-22 17:30:00+00:00,24,13,11,No Signal,16541.744140625
2021-11-22 18:30:00+00:00,24,9,15,No Signal,16534.9140625
2021-11-22 19:30:00+00:00,23,12,11,No Signal,16550.9765625
2021-11-22 20:30:00+00:00,29,7,22,No Signal,16377.4130859375
2021-11-23 14:30:00+00:00,35,6,29,No Signal,16246.1044921875
2021-11-23 15:30:00+00:00,39,9,30,No Signal,16249.1884765625
2021-11-23 16:30:00+00:00,37,6,31,No Signal,16223.28125
2021-11-23 17:30:00+00:00,37,7,30,No Signal,16152.453125
2021-11-23 18:30:00+00:00,33,6,27,No Signal,16167.3251953125
2021-11-23 19:30:00+00:00,32,6,26,No Signal,16248.4765625
2021-11-23 20:30:00+00:00,24,8,16,No Signal,16310.9765625
2021-11-24 14:30:00+00:00,32,1,31,No Signal,16251.6806640625
2021-11-24 15:30:00+00:00,18,0,18,No Signal,16317.58984375
2021-11-24 16:30:00+00:00,15,1,14,No Signal,16285.1337890625
2021-11-24 17:30:00+00:00,12,2,10,No Signal,16327.6025390625
2021-11-24 18:30:00+00:00,15,1,14,No Signal,16284.2119140625
2021-11-24 19:30:00+00:00,11,2,9,No Signal,16357.9423828125
2021-11-24 20:30:00+00:00,5,7,-2,No Signal,16370.560546875
2021-11-26 14:30:00+00:00,8,11,-3,No Signal,16175.654296875
2021-11-26 15:30:00+00:00,19,5,14,No Signal,16075.9189453125
2021-11-26 16:30:00+00:00,15,6,9,No Signal,16120.6279296875
2021-11-29 14:30:00+00:00,8,6,2,No Signal,16270.201171875
2021-11-29 15:30:00+00:00,8,8,0,No Signal,16293.5859375
2021-11-29 16:30:00+00:00,7,9,-2,No Signal,16385.580078125
2021-11-29 17:30:00+00:00,5,9,-4,No Signal,16402.478515625
2021-11-29 18:30:00+00:00,8,12,-4,No Signal,16399.734375
2021-11-29 19:30:00+00:00,9,13,-4,No Signal,16419.787109375
2021-11-29 20:30:00+00:00,8,10,-2,No Signal,16396.05078125
2021-11-30 14:30:00+00:00,16,8,8,No Signal,16413.099609375
2021-11-30 15:30:00+00:00,18,1,17,No Signal,16174.84375
2021-11-30 16:30:00+00:00,26,1,25,No Signal,16140.2197265625
2021-11-30 17:30:00+00:00,26,1,25,No Signal,16134.1640625
2021-11-30 18:30:00+00:00,12,3,9,No Signal,16199.7060546875
2021-11-30 19:30:00+00:00,12,5,7,No Signal,16122.41796875
2021-11-30 20:30:00+00:00,22,4,18,No Signal,16143.68359375
2021-12-01 14:30:00+00:00,18,8,10,No Signal,16315.3486328125
2021-12-01 15:30:00+00:00,17,10,7,No Signal,16410.79296875
2021-12-01 16:30:00+00:00,22,6,16,No Signal,16330.6796875
2021-12-01 17:30:00+00:00,27,2,25,No Signal,16252.7822265625
2021-12-01 18:30:00+00:00,29,2,27,No Signal,16187.341796875
2021-12-01 19:30:00+00:00,47,0,47,No Signal,15986.755859375
2021-12-01 20:30:00+00:00,50,1,49,No Signal,15864.435546875
2021-12-02 14:30:00+00:00,27,0,27,No Signal,15908.79296875
2021-12-02 15:30:00+00:00,18,1,17,No Signal,15961.294921875
2021-12-02 16:30:00+00:00,11,1,10,No Signal,16048.9091796875
2021-12-02 17:30:00+00:00,14,1,13,No Signal,15946.3359375
2021-12-02 18:30:00+00:00,11,1,10,No Signal,16020.7822265625
2021-12-02 19:30:00+00:00,10,1,9,No Signal,15992.0380859375
2021-12-02 20:30:00+00:00,12,1,11,No Signal,15991.3017578125
2021-12-03 14:30:00+00:00,32,1,31,No Signal,15810.248046875
2021-12-03 15:30:00+00:00,39,1,38,No Signal,15711.423828125
2021-12-03 16:30:00+00:00,35,1,34,No Signal,15647.2587890625
2021-12-03 17:30:00+00:00,30,1,29,No Signal,15650.6279296875
2021-12-03 18:30:00+00:00,29,2,27,No Signal,15622.0517578125
2021-12-03 19:30:00+00:00,25,4,21,No Signal,15613.791015625
2021-12-03 20:30:00+00:00,14,16,-2,No Signal,15715.91015625
2021-12-06 14:30:00+00:00,17,16,1,No Signal,15763.2861328125
2021-12-06 15:30:00+00:00,22,13,9,No Signal,15708.0693359375
2021-12-06 16:30:00+00:00,22,11,11,No Signal,15783.5419921875
2021-12-06 17:30:00+00:00,12,16,-4,No Signal,15871.796875
2021-12-06 18:30:00+00:00,15,11,4,No Signal,15885.1884765625
2021-12-06 19:30:00+00:00,14,12,2,No Signal,15855.5810546875
2021-12-06 20:30:00+00:00,15,11,4,No Signal,15843.236328125
2021-12-07 14:30:00+00:00,1,39,-38,Short,16238.517578125
2021-12-07 15:30:00+00:00,1,54,-53,No Signal,16277.1943359375
2021-12-07 16:30:00+00:00,1,57,-56,No Signal,16308.9150390625
2021-12-07 17:30:00+00:00,1,58,-57,No Signal,16314.84375
2021-12-07 18:30:00+00:00,1,67,-66,No Signal,16320.49609375
2021-12-07 19:30:00+00:00,1,62,-61,No Signal,16268.638671875
2021-12-07 20:30:00+00:00,1,58,-57,No Signal,16323.9951171875
2021-12-08 14:30:00+00:00,3,41,-38,No Signal,16294.6943359375
2021-12-08 15:30:00+00:00,4,54,-50,No Signal,16320.8232421875
2021-12-08 16:30:00+00:00,4,53,-49,No Signal,16307.16015625
2021-12-08 17:30:00+00:00,1,48,-47,No Signal,16345.45703125
2021-12-08 18:30:00+00:00,1,42,-41,No Signal,16354.7626953125
2021-12-08 19:30:00+00:00,1,54,-53,No Signal,16372.05078125
2021-12-08 20:30:00+00:00,1,60,-59,No Signal,16393.90625
2021-12-09 14:30:00+00:00,8,13,-5,No Signal,16277.9267578125
2021-12-09 15:30:00+00:00,9,14,-5,No Signal,16335.720703125
2021-12-09 16:30:00+00:00,9,7,2,No Signal,16279.8291015625
2021-12-09 17:30:00+00:00,9,5,4,No Signal,16270.8994140625
2021-12-09 18:30:00+00:00,12,6,6,No Signal,16238.685546875
2021-12-09 19:30:00+00:00,10,3,7,No Signal,16171.671875
2021-12-09 20:30:00+00:00,17,1,16,Long,16151.056640625
2021-12-10 14:30:00+00:00,10,9,1,No Signal,16291.083984375
2021-12-10 15:30:00+00:00,23,9,14,No Signal,16211.28515625
2021-12-10 16:30:00+00:00,21,10,11,No Signal,16244.724609375
2021-12-10 17:30:00+00:00,23,10,13,No Signal,16270.6826171875
2021-12-10 18:30:00+00:00,23,10,13,No Signal,16263.056640625
2021-12-10 19:30:00+00:00,30,8,22,No Signal,16272.6181640625
2021-12-10 20:30:00+00:00,28,10,18,No Signal,16329.48046875
2021-12-13 14:30:00+00:00,24,10,14,No Signal,16216.4326171875
2021-12-13 15:30:00+00:00,32,8,24,No Signal,16156.6826171875
2021-12-13 16:30:00+00:00,29,10,19,No Signal,16174.29296875
2021-12-13 17:30:00+00:00,25,9,16,No Signal,16149.7470703125
2021-12-13 18:30:00+00:00,18,9,9,No Signal,16174.0244140625
2021-12-13 19:30:00+00:00,13,18,-5,No Signal,16156.1337890625
2021-12-13 20:30:00+00:00,15,18,-3,No Signal,16085.2978515625
2021-12-14 14:30:00+00:00,34,3,31,No Signal,15921.876953125
2021-12-14 15:30:00+00:00,39,6,33,No Signal,15816.4052734375
2021-12-14 16:30:00+00:00,43,3,40,No Signal,15772.71875
2021-12-14 17:30:00+00:00,50,2,48,No Signal,15792.966796875
2021-12-14 18:30:00+00:00,44,5,39,No Signal,15834.490234375
2021-12-14 19:30:00+00:00,27,6,21,No Signal,15942.248046875
2021-12-14 20:30:00+00:00,38,5,33,No Signal,15922.126953125
2021-12-15 14:30:00+00:00,32,4,28,No Signal,15857.8818359375
2021-12-15 15:30:00+00:00,30,4,26,No Signal,15816.888671875
2021-12-15 16:30:00+00:00,34,4,30,No Signal,15792.3447265625
2021-12-15 17:30:00+00:00,31,2,29,No Signal,15807.5341796875
2021-12-15 18:30:00+00:00,19,3,16,No Signal,15918.552734375
2021-12-15 19:30:00+00:00,2,8,-6,No Signal,16205.853515625
2021-12-15 20:30:00+00:00,1,13,-12,Short,16292.8623046875
2021-12-16 14:30:00+00:00,2,24,-22,No Signal,16178.208984375
2021-12-16 15:30:00+00:00,2,21,-19,No Signal,16064.2900390625
2021-12-16 16:30:00+00:00,4,18,-14,No Signal,15949.4658203125
2021-12-16 17:30:00+00:00,4,19,-15,No Signal,15966.5478515625
2021-12-16 18:30:00+00:00,5,15,-10,No Signal,15857.5087890625
2021-12-16 19:30:00+00:00,4,11,-7,No Signal,15889.3291015625
2021-12-16 20:30:00+00:00,4,13,-9,No Signal,15867.271484375
2021-12-17 14:30:00+00:00,5,8,-3,No Signal,15739.4755859375
2021-12-17 15:30:00+00:00,4,17,-13,No Signal,15925.2890625
2021-12-17 16:30:00+00:00,4,11,-7,No Signal,15815.19921875
2021-12-17 17:30:00+00:00,3,15,-12,No Signal,15882.224609375
2021-12-17 18:30:00+00:00,5,14,-9,No Signal,15859.6025390625
2021-12-17 19:30:00+00:00,19,5,14,Long,15844.7490234375
2021-12-17 20:30:00+00:00,32,4,28,No Signal,15797.1240234375
2021-12-20 14:30:00+00:00,46,4,42,No Signal,15591.7919921875
2021-12-20 15:30:00+00:00,40,4,36,No Signal,15535.359375
2021-12-20 16:30:00+00:00,29,4,25,No Signal,15571.80078125
2021-12-20 17:30:00+00:00,28,4,24,No Signal,15550.4951171875
2021-12-20 18:30:00+00:00,22,5,17,No Signal,15583.654296875
2021-12-20 19:30:00+00:00,20,5,15,No Signal,15624.4140625
2021-12-20 20:30:00+00:00,14,4,10,No Signal,15624.2705078125
2021-12-21 14:30:00+00:00,8,6,2,No Signal,15636.4013671875
2021-12-21 15:30:00+00:00,15,6,9,No Signal,15730.5146484375
2021-12-21 16:30:00+00:00,2,9,-7,No Signal,15843.6416015625
2021-12-21 17:30:00+00:00,5,6,-1,No Signal,15892.015625
2021-12-21 18:30:00+00:00,4,12,-8,No Signal,15944.60546875
2021-12-21 19:30:00+00:00,3,14,-11,Short,15949.0712890625
2021-12-21 20:30:00+00:00,2,19,-17,No Signal,15986.4970703125
2021-12-22 14:30:00+00:00,1,45,-44,No Signal,16016.458984375
2021-12-22 15:30:00+00:00,1,63,-62,No Signal,16121.36328125
2021-12-22 16:30:00+00:00,1,63,-62,No Signal,16116.1103515625
2021-12-22 17:30:00+00:00,1,61,-60,No Signal,16085.1591796875
2021-12-22 18:30:00+00:00,1,56,-55,No Signal,16056.0634765625
2021-12-22 19:30:00+00:00,1,55,-54,No Signal,16128.04296875
2021-12-22 20:30:00+00:00,1,61,-60,No Signal,16179.466796875
2021-12-23 14:30:00+00:00,1,66,-65,No Signal,16270.8173828125
2021-12-23 15:30:00+00:00,1,60,-59,No Signal,16304.2119140625
2021-12-23 16:30:00+00:00,0,46,-46,No Signal,16311.3896484375
2021-12-23 17:30:00+00:00,1,47,-46,No Signal,16335.20703125
2021-12-23 18:30:00+00:00,2,50,-48,No Signal,16333.9599609375
2021-12-23 19:30:00+00:00,1,47,-46,No Signal,16322.7705078125
2021-12-23 20:30:00+00:00,2,40,-38,No Signal,16303.7197265625
2021-12-27 14:30:00+00:00,3,59,-56,No Signal,16506.486328125
2021-12-27 15:30:00+00:00,2,49,-47,No Signal,16522.115234375
2021-12-27 16:30:00+00:00,2,52,-50,No Signal,16532.408203125
2021-12-27 17:30:00+00:00,2,52,-50,No Signal,16544.998046875
2021-12-27 18:30:00+00:00,1,54,-53,No Signal,16559.224609375
2021-12-27 19:30:00+00:00,2,54,-52,No Signal,16541.087890625
2021-12-27 20:30:00+00:00,2,52,-50,No Signal,16567.46875
2021-12-28 14:30:00+00:00,3,34,-31,No Signal,16551.701171875
2021-12-28 15:30:00+00:00,4,34,-30,No Signal,16528.26171875
2021-12-28 16:30:00+00:00,2,35,-33,No Signal,16514.052734375
2021-12-28 17:30:00+00:00,6,30,-24,No Signal,16496.978515625
2021-12-28 18:30:00+00:00,6,28,-22,No Signal,16488.830078125
2021-12-28 19:30:00+00:00,3,33,-30,No Signal,16501.650390625
2021-12-28 20:30:00+00:00,3,34,-31,No Signal,16492.74609375
2021-12-29 14:30:00+00:00,20,24,-4,No Signal,16438.228515625
2021-12-29 15:30:00+00:00,14,22,-8,No Signal,16451.423828125
2021-12-29 16:30:00+00:00,20,15,5,No Signal,16429.56640625
2021-12-29 17:30:00+00:00,17,19,-2,No Signal,16446.904296875
2021-12-29 18:30:00+00:00,13,20,-7,No Signal,16486.662109375
2021-12-29 19:30:00+00:00,10,23,-13,No Signal,16488.27734375
2021-12-29 20:30:00+00:00,9,16,-7,No Signal,16491.546875
2021-12-30 14:30:00+00:00,2,11,-9,No Signal,16560.87109375
2021-12-30 15:30:00+00:00,2,12,-10,No Signal,16551.552734375
2021-12-30 16:30:00+00:00,1,12,-11,No Signal,16545.654296875
2021-12-30 17:30:00+00:00,1,15,-14,No Signal,16542.76171875
2021-12-30 18:30:00+00:00,2,14,-12,No Signal,16530.029296875
2021-12-30 19:30:00+00:00,1,13,-12,No Signal,16501.89453125
2021-12-30 20:30:00+00:00,3,6,-3,No Signal,16436.091796875
2021-12-31 14:30:00+00:00,8,8,0,No Signal,16405.947265625
2021-12-31 15:30:00+00:00,9,9,0,No Signal,16404.130859375
2021-12-31 16:30:00+00:00,8,8,0,No Signal,16366.5185546875
2021-12-31 17:30:00+00:00,9,9,0,No Signal,16390.689453125
2021-12-31 18:30:00+00:00,17,5,12,Long,16367.2734375
2021-12-31 19:30:00+00:00,16,8,8,No Signal,16384.923828125
2021-12-31 20:30:00+00:00,26,5,21,No Signal,16321.5546875
2022-01-03 14:30:00+00:00,38,3,35,No Signal,16421.3515625
2022-01-03 15:30:00+00:00,46,1,45,No Signal,16415.970703125
2022-01-03 16:30:00+00:00,44,2,42,No Signal,16422.9296875
2022-01-03 17:30:00+00:00,45,2,43,No Signal,16438.314453125
2022-01-03 18:30:00+00:00,37,3,34,No Signal,16470.513671875
2022-01-03 19:30:00+00:00,33,4,29,No Signal,16490.12890625
2022-01-03 20:30:00+00:00,23,10,13,No Signal,16496.564453125
2022-01-04 14:30:00+00:00,36,9,27,No Signal,16408.87890625
2022-01-04 15:30:00+00:00,36,6,30,No Signal,16197.509765625
2022-01-04 16:30:00+00:00,36,5,31,No Signal,16221.0625
2022-01-04 17:30:00+00:00,40,4,36,No Signal,16205.134765625
2022-01-04 18:30:00+00:00,41,4,37,No Signal,16177.1064453125
2022-01-04 19:30:00+00:00,25,4,21,No Signal,16295.6123046875
2022-01-04 20:30:00+00:00,23,7,16,No Signal,16278.8828125
2022-01-05 14:30:00+00:00,22,10,12,No Signal,16206.8837890625
2022-01-05 15:30:00+00:00,24,13,11,No Signal,16172.3408203125
2022-01-05 16:30:00+00:00,26,12,14,No Signal,16140.111328125
2022-01-05 17:30:00+00:00,32,10,22,No Signal,16082.2578125
2022-01-05 18:30:00+00:00,47,7,40,No Signal,15981.4931640625
2022-01-05 19:30:00+00:00,53,5,48,No Signal,15844.2890625
2022-01-05 20:30:00+00:00,57,2,55,No Signal,15764.9140625
2022-01-06 14:30:00+00:00,42,1,41,No Signal,15775.068359375
2022-01-06 15:30:00+00:00,27,0,27,No Signal,15829.3701171875
2022-01-06 16:30:00+00:00,27,2,25,No Signal,15838.5380859375
2022-01-06 17:30:00+00:00,30,1,29,No Signal,15785.5625
2022-01-06 18:30:00+00:00,25,4,21,No Signal,15807.943359375
2022-01-06 19:30:00+00:00,36,1,35,No Signal,15813.361328125
2022-01-06 20:30:00+00:00,41,1,40,No Signal,15767.13671875
2022-01-07 14:30:00+00:00,46,3,43,No Signal,15672.8896484375
2022-01-07 15:30:00+00:00,48,5,43,No Signal,15624.107421875
2022-01-07 16:30:00+00:00,45,2,43,No Signal,15631.185546875
2022-01-07 17:30:00+00:00,46,3,43,No Signal,15625.107421875
2022-01-07 18:30:00+00:00,42,3,39,No Signal,15590.7890625
2022-01-07 19:30:00+00:00,33,8,25,No Signal,15622.6015625
2022-01-07 20:30:00+00:00,31,9,22,No Signal,15588.716796875
2022-01-10 14:30:00+00:00,53,4,49,No Signal,15241.359375
2022-01-10 15:30:00+00:00,56,3,53,No Signal,15337.1845703125
2022-01-10 16:30:00+00:00,62,2,60,No Signal,15230.7744140625
2022-01-10 17:30:00+00:00,48,2,46,No Signal,15370.154296875
2022-01-10 18:30:00+00:00,37,4,33,No Signal,15486.794921875
2022-01-10 19:30:00+00:00,37,3,34,No Signal,15489.1025390625
2022-01-10 20:30:00+00:00,18,6,12,No Signal,15614.064453125
2022-01-11 14:30:00+00:00,13,7,6,No Signal,15612.4716796875
2022-01-11 15:30:00+00:00,6,8,-2,No Signal,15759.6875
2022-01-11 16:30:00+00:00,5,5,0,No Signal,15759.9404296875
2022-01-11 17:30:00+00:00,4,7,-3,No Signal,15795.5439453125
2022-01-11 18:30:00+00:00,3,10,-7,No Signal,15799.322265625
2022-01-11 19:30:00+00:00,1,11,-10,Short,15830.2705078125
2022-01-11 20:30:00+00:00,1,12,-11,No Signal,15842.337890625
2022-01-12 14:30:00+00:00,2,60,-58,No Signal,15990.5517578125
2022-01-12 15:30:00+00:00,1,45,-44,No Signal,15879.30859375
2022-01-12 16:30:00+00:00,0,59,-59,No Signal,15916.4033203125
2022-01-12 17:30:00+00:00,0,52,-52,No Signal,15909.0205078125
2022-01-12 18:30:00+00:00,0,45,-45,No Signal,15924.5126953125
2022-01-12 19:30:00+00:00,0,39,-39,No Signal,15883.73046875
2022-01-12 20:30:00+00:00,1,28,-27,No Signal,15903.736328125
2022-01-13 14:30:00+00:00,2,31,-29,No Signal,15875.662109375
2022-01-13 15:30:00+00:00,8,21,-13,No Signal,15820.322265625
2022-01-13 16:30:00+00:00,16,10,6,No Signal,15646.0517578125
2022-01-13 17:30:00+00:00,14,10,4,No Signal,15680.08203125
2022-01-13 18:30:00+00:00,16,8,8,No Signal,15641.8330078125
2022-01-13 19:30:00+00:00,27,3,24,Long,15587.935546875
2022-01-13 20:30:00+00:00,31,3,28,No Signal,15504.6884765625
2022-01-14 14:30:00+00:00,48,6,42,No Signal,15525.3662109375
2022-01-14 15:30:00+00:00,44,4,40,No Signal,15479.8779296875
2022-01-14 16:30:00+00:00,47,3,44,No Signal,15524.724609375
2022-01-14 17:30:00+00:00,51,3,48,No Signal,15433.841796875
2022-01-14 18:30:00+00:00,47,3,44,No Signal,15491.66796875
2022-01-14 19:30:00+00:00,32,6,26,No Signal,15573.94921875
2022-01-14 20:30:00+00:00,28,6,22,No Signal,15606.705078125
2022-01-18 14:30:00+00:00,39,2,37,No Signal,15425.7119140625
2022-01-18 15:30:00+00:00,47,0,47,No Signal,15302.9931640625
2022-01-18 16:30:00+00:00,35,1,34,No Signal,15301.525390625
2022-01-18 17:30:00+00:00,41,1,40,No Signal,15253.2314453125
2022-01-18 18:30:00+00:00,34,2,32,No Signal,15272.6357421875
2022-01-18 19:30:00+00:00,34,3,31,No Signal,15258.2509765625
2022-01-18 20:30:00+00:00,32,1,31,No Signal,15218.9765625
2022-01-19 14:30:00+00:00,20,1,19,No Signal,15298.7236328125
2022-01-19 15:30:00+00:00,25,2,23,No Signal,15150.763671875
2022-01-19 16:30:00+00:00,13,3,10,No Signal,15305.7021484375
2022-01-19 17:30:00+00:00,11,3,8,No Signal,15275.0400390625
2022-01-19 18:30:00+00:00,18,4,14,No Signal,15168.5244140625
2022-01-19 19:30:00+00:00,37,1,36,No Signal,15149.3515625
2022-01-19 20:30:00+00:00,47,0,47,No Signal,15046.9560546875
2022-01-20 14:30:00+00:00,17,4,13,No Signal,15283.7587890625
2022-01-20 15:30:00+00:00,10,6,4,No Signal,15312.814453125
2022-01-20 16:30:00+00:00,7,5,2,No Signal,15295.5888671875
2022-01-20 17:30:00+00:00,10,6,4,No Signal,15216.5615234375
2022-01-20 18:30:00+00:00,15,3,12,No Signal,15147.626953125
2022-01-20 19:30:00+00:00,20,2,18,No Signal,14981.98828125
2022-01-20 20:30:00+00:00,22,4,18,No Signal,14847.4384765625
2022-01-21 14:30:00+00:00,29,2,27,No Signal,14639.2294921875
2022-01-21 15:30:00+00:00,11,1,10,No Signal,14849.7724609375
2022-01-21 16:30:00+00:00,27,1,26,No Signal,14664.7919921875
2022-01-21 17:30:00+00:00,30,0,30,No Signal,14612.7900390625
2022-01-21 18:30:00+00:00,24,0,24,No Signal,14577.2763671875
2022-01-21 19:30:00+00:00,33,1,32,No Signal,14479.8916015625
2022-01-21 20:30:00+00:00,22,1,21,No Signal,14432.6357421875
2022-01-24 14:30:00+00:00,74,0,74,No Signal,14092.7666015625
2022-01-24 15:30:00+00:00,76,3,73,No Signal,14032.59375
2022-01-24 16:30:00+00:00,81,1,80,No Signal,13802.75
2022-01-24 17:30:00+00:00,73,1,72,No Signal,13990.0224609375
2022-01-24 18:30:00+00:00,55,1,54,No Signal,14084.9228515625
2022-01-24 19:30:00+00:00,23,1,22,No Signal,14275.255859375
2022-01-24 20:30:00+00:00,6,0,6,No Signal,14517.099609375
2022-01-25 14:30:00+00:00,4,0,4,No Signal,14215.546875
2022-01-25 15:30:00+00:00,18,1,17,No Signal,14145.6982421875
2022-01-25 16:30:00+00:00,9,0,9,No Signal,14133.1259765625
2022-01-25 17:30:00+00:00,3,1,2,No Signal,14186.203125
2022-01-25 18:30:00+00:00,1,0,1,No Signal,14328.81640625
2022-01-25 19:30:00+00:00,1,1,0,No Signal,14224.1220703125
2022-01-25 20:30:00+00:00,1,0,1,No Signal,14154.716796875
2022-01-26 14:30:00+00:00,1,3,-2,No Signal,14395.720703125
2022-01-26 15:30:00+00:00,0,10,-10,Short,14447.380859375
2022-01-26 16:30:00+00:00,0,26,-26,No Signal,14509.7431640625
2022-01-26 17:30:00+00:00,1,13,-12,No Signal,14508.865234375
2022-01-26 18:30:00+00:00,1,10,-9,No Signal,14521.90625
2022-01-26 19:30:00+00:00,10,0,10,Long,14179.6728515625
2022-01-26 20:30:00+00:00,32,0,32,No Signal,14168.8994140625
2022-01-27 14:30:00+00:00,10,3,7,No Signal,14275.6826171875
2022-01-27 15:30:00+00:00,7,4,3,No Signal,14263.6826171875
2022-01-27 16:30:00+00:00,9,2,7,No Signal,14175.0576171875
2022-01-27 17:30:00+00:00,16,2,14,No Signal,14005.044921875
2022-01-27 18:30:00+00:00,22,1,21,No Signal,14027.966796875
2022-01-27 19:30:00+00:00,19,1,18,No Signal,14014.3466796875
2022-01-27 20:30:00+00:00,17,1,16,No Signal,13998.888671875
2022-01-28 14:30:00+00:00,47,1,46,No Signal,13980.1005859375
2022-01-28 15:30:00+00:00,23,1,22,No Signal,14232.05859375
2022-01-28 16:30:00+00:00,22,2,20,No Signal,14242.751953125
2022-01-28 17:30:00+00:00,25,1,24,No Signal,14224.4052734375
2022-01-28 18:30:00+00:00,32,1,31,No Signal,14105.2919921875
2022-01-28 19:30:00+00:00,4,7,-3,No Signal,14270.751953125
2022-01-28 20:30:00+00:00,3,9,-6,No Signal,14451.0537109375
2022-01-31 14:30:00+00:00,0,10,-10,Short,14680.6259765625
2022-01-31 15:30:00+00:00,1,17,-16,No Signal,14690.509765625
2022-01-31 16:30:00+00:00,0,37,-37,No Signal,14753.01953125
2022-01-31 17:30:00+00:00,0,64,-64,No Signal,14762.8330078125
2022-01-31 18:30:00+00:00,0,67,-67,No Signal,14833.16015625
2022-01-31 19:30:00+00:00,1,67,-66,No Signal,14786.42578125
2022-01-31 20:30:00+00:00,0,73,-73,No Signal,14930.8212890625
2022-02-01 14:30:00+00:00,0,71,-71,No Signal,14837.8642578125
2022-02-01 15:30:00+00:00,0,63,-63,No Signal,14909.353515625
2022-02-01 16:30:00+00:00,0,62,-62,No Signal,14908.3046875
2022-02-01 17:30:00+00:00,0,61,-61,No Signal,14917.275390625
2022-02-01 18:30:00+00:00,0,72,-72,No Signal,14867.8115234375
2022-02-01 19:30:00+00:00,0,66,-66,No Signal,14964.2080078125
2022-02-01 20:30:00+00:00,1,61,-60,No Signal,15012.6259765625
2022-02-02 14:30:00+00:00,2,34,-32,No Signal,15081.2861328125
2022-02-02 15:30:00+00:00,2,29,-27,No Signal,15018.0791015625
2022-02-02 16:30:00+00:00,2,24,-22,No Signal,15049.6640625
2022-02-02 17:30:00+00:00,2,24,-22,No Signal,15070.45703125
2022-02-02 18:30:00+00:00,2,24,-22,No Signal,15067.578125
2022-02-02 19:30:00+00:00,1,29,-28,No Signal,15123.337890625
2022-02-02 20:30:00+00:00,3,20,-17,No Signal,15132.6494140625
2022-02-03 14:30:00+00:00,8,31,-23,No Signal,14829.5810546875
2022-02-03 15:30:00+00:00,18,19,-1,No Signal,14739.6962890625
2022-02-03 16:30:00+00:00,20,17,3,No Signal,14692.771484375
2022-02-03 17:30:00+00:00,20,18,2,No Signal,14702.279296875
2022-02-03 18:30:00+00:00,19,15,4,No Signal,14656.005859375
2022-02-03 19:30:00+00:00,29,11,18,Long,14614.599609375
2022-02-03 20:30:00+00:00,39,9,30,No Signal,14498.177734375
2022-02-04 14:30:00+00:00,27,3,24,No Signal,14585.796875
2022-02-04 15:30:00+00:00,34,2,32,No Signal,14549.6787109375
2022-02-04 16:30:00+00:00,30,1,29,No Signal,14605.9033203125
2022-02-04 17:30:00+00:00,24,2,22,No Signal,14721.2451171875
2022-02-04 18:30:00+00:00,20,2,18,No Signal,14734.416015625
2022-02-04 19:30:00+00:00,21,2,19,No Signal,14791.541015625
2022-02-04 20:30:00+00:00,31,1,30,No Signal,14691.7197265625
2022-02-07 14:30:00+00:00,12,5,7,No Signal,14750.6650390625
2022-02-07 15:30:00+00:00,13,6,7,No Signal,14683.875
2022-02-07 16:30:00+00:00,17,4,13,No Signal,14607.494140625
2022-02-07 17:30:00+00:00,13,6,7,No Signal,14671.52734375
2022-02-07 18:30:00+00:00,9,9,0,No Signal,14698.662109375
2022-02-07 19:30:00+00:00,9,5,4,No Signal,14651.9814453125
2022-02-07 20:30:00+00:00,7,9,-2,No Signal,14573.06640625
2022-02-08 14:30:00+00:00,3,5,-2,No Signal,14515.548828125
2022-02-08 15:30:00+00:00,1,20,-19,Short,14677.03125
2022-02-08 16:30:00+00:00,2,19,-17,No Signal,14710.529296875
2022-02-08 17:30:00+00:00,3,12,-9,No Signal,14698.63671875
2022-02-08 18:30:00+00:00,5,8,-3,No Signal,14648.80078125
2022-02-08 19:30:00+00:00,7,8,-1,No Signal,14704.623046875
2022-02-08 20:30:00+00:00,4,14,-10,No Signal,14743.162109375
2022-02-09 14:30:00+00:00,0,22,-22,No Signal,14913.82421875
2022-02-09 15:30:00+00:00,1,27,-26,No Signal,14954.580078125
2022-02-09 16:30:00+00:00,0,42,-42,No Signal,14968.5849609375
2022-02-09 17:30:00+00:00,0,37,-37,No Signal,14990.7578125
2022-02-09 18:30:00+00:00,1,38,-37,No Signal,15021.1396484375
2022-02-09 19:30:00+00:00,1,46,-45,No Signal,15015.162109375
2022-02-09 20:30:00+00:00,1,53,-52,No Signal,15055.5908203125
2022-02-10 14:30:00+00:00,5,52,-47,No Signal,14963.0673828125
2022-02-10 15:30:00+00:00,9,39,-30,No Signal,14920.017578125
2022-02-10 16:30:00+00:00,7,42,-35,No Signal,14972.36328125
2022-02-10 17:30:00+00:00,8,23,-15,No Signal,14795.8427734375
2022-02-10 18:30:00+00:00,8,29,-21,No Signal,14779.8115234375
2022-02-10 19:30:00+00:00,10,12,-2,No Signal,14738.84765625
2022-02-10 20:30:00+00:00,10,8,2,No Signal,14704.517578125
2022-02-11 14:30:00+00:00,23,6,17,Long,14663.8623046875
2022-02-11 15:30:00+00:00,44,4,40,No Signal,14589.34375
2022-02-11 16:30:00+00:00,43,4,39,No Signal,14584.025390625
2022-02-11 17:30:00+00:00,54,3,51,No Signal,14495.029296875
2022-02-11 18:30:00+00:00,68,1,67,No Signal,14292.2568359375
2022-02-11 19:30:00+00:00,65,1,64,No Signal,14271.92578125
2022-02-11 20:30:00+00:00,68,1,67,No Signal,14245.244140625
2022-02-14 14:30:00+00:00,68,0,68,No Signal,14284.2275390625
2022-02-14 15:30:00+00:00,63,1,62,No Signal,14372.1474609375
2022-02-14 16:30:00+00:00,67,0,67,No Signal,14373.083984375
2022-02-14 17:30:00+00:00,56,0,56,No Signal,14309.890625
2022-02-14 18:30:00+00:00,58,0,58,No Signal,14223.37109375
2022-02-14 19:30:00+00:00,52,0,52,No Signal,14258.45703125
2022-02-14 20:30:00+00:00,48,0,48,No Signal,14269.9013671875
2022-02-15 14:30:00+00:00,15,0,15,No Signal,14505.20703125
2022-02-15 15:30:00+00:00,6,0,6,No Signal,14526.7451171875
2022-02-15 16:30:00+00:00,10,0,10,No Signal,14489.9345703125
2022-02-15 17:30:00+00:00,6,0,6,No Signal,14543.9326171875
2022-02-15 18:30:00+00:00,3,22,-19,Short,14553.8193359375
2022-02-15 19:30:00+00:00,3,28,-25,No Signal,14591.453125
2022-02-15 20:30:00+00:00,1,35,-34,No Signal,14621.79296875
2022-02-16 14:30:00+00:00,1,12,-11,No Signal,14439.8134765625
2022-02-16 15:30:00+00:00,2,11,-9,No Signal,14461.123046875
2022-02-16 16:30:00+00:00,2,12,-10,No Signal,14449.306640625
2022-02-16 17:30:00+00:00,2,15,-13,No Signal,14443.470703125
2022-02-16 18:30:00+00:00,2,31,-29,No Signal,14567.439453125
2022-02-16 19:30:00+00:00,2,38,-36,No Signal,14641.591796875
2022-02-16 20:30:00+00:00,2,32,-30,No Signal,14604.017578125
2022-02-17 14:30:00+00:00,13,5,8,No Signal,14351.3515625
2022-02-17 15:30:00+00:00,10,5,5,No Signal,14406.6005859375
2022-02-17 16:30:00+00:00,11,1,10,Long,14352.9375
2022-02-17 17:30:00+00:00,16,2,14,No Signal,14311.1494140625
2022-02-17 18:30:00+00:00,17,2,15,No Signal,14280.9873046875
2022-02-17 19:30:00+00:00,28,0,28,No Signal,14205.658203125
2022-02-17 20:30:00+00:00,38,0,38,No Signal,14173.5546875
2022-02-18 14:30:00+00:00,27,1,26,No Signal,14104.1611328125
2022-02-18 15:30:00+00:00,40,2,38,No Signal,14041.3740234375
2022-02-18 16:30:00+00:00,41,1,40,No Signal,14023.66796875
2022-02-18 17:30:00+00:00,49,1,48,No Signal,13939.984375
2022-02-18 18:30:00+00:00,43,1,42,No Signal,14094.015625
2022-02-18 19:30:00+00:00,61,1,60,No Signal,14024.578125
2022-02-18 20:30:00+00:00,55,1,54,No Signal,14004.197265625
2022-02-22 14:30:00+00:00,18,1,17,No Signal,14106.98046875
2022-02-22 15:30:00+00:00,37,2,35,No Signal,13902.2509765625
2022-02-22 16:30:00+00:00,32,0,32,No Signal,13862.48046875
2022-02-22 17:30:00+00:00,36,0,36,No Signal,13818.4599609375
2022-02-22 18:30:00+00:00,34,0,34,No Signal,13805.6142578125
2022-02-22 19:30:00+00:00,12,0,12,No Signal,13976.5029296875
2022-02-22 20:30:00+00:00,15,0,15,No Signal,13872.2119140625
2022-02-23 14:30:00+00:00,15,0,15,No Signal,13814.369140625
2022-02-23 15:30:00+00:00,13,0,13,No Signal,13743.0068359375
2022-02-23 16:30:00+00:00,6,1,5,No Signal,13861.7392578125
2022-02-23 17:30:00+00:00,9,0,9,No Signal,13681.13671875
2022-02-23 18:30:00+00:00,21,1,20,No Signal,13624.556640625
2022-02-23 19:30:00+00:00,19,0,19,No Signal,13589.1025390625
2022-02-23 20:30:00+00:00,26,0,26,No Signal,13512.7333984375
2022-02-24 14:30:00+00:00,61,0,61,No Signal,13379.0146484375
2022-02-24 15:30:00+00:00,31,1,30,No Signal,13500.1328125
2022-02-24 16:30:00+00:00,30,1,29,No Signal,13454.05078125
2022-02-24 17:30:00+00:00,23,4,19,No Signal,13493.318359375
2022-02-24 18:30:00+00:00,15,2,13,No Signal,13671.4638671875
2022-02-24 19:30:00+00:00,15,1,14,No Signal,13821.5263671875
2022-02-24 20:30:00+00:00,6,7,-1,No Signal,13970.5
2022-02-25 14:30:00+00:00,3,8,-5,No Signal,14006.611328125
2022-02-25 15:30:00+00:00,3,16,-13,Short,14126.44921875
2022-02-25 16:30:00+00:00,1,14,-13,No Signal,14150.509765625
2022-02-25 17:30:00+00:00,3,28,-25,No Signal,14112.1875
2022-02-25 18:30:00+00:00,1,44,-43,No Signal,14138.705078125
2022-02-25 19:30:00+00:00,1,47,-46,No Signal,14143.7646484375
2022-02-25 20:30:00+00:00,0,62,-62,No Signal,14192.0224609375
2022-02-28 14:30:00+00:00,0,60,-60,No Signal,14105.99609375
2022-02-28 15:30:00+00:00,0,65,-65,No Signal,14271.181640625
2022-02-28 16:30:00+00:00,0,51,-51,No Signal,14154.736328125
2022-02-28 17:30:00+00:00,0,44,-44,No Signal,14122.2548828125
2022-02-28 18:30:00+00:00,0,23,-23,No Signal,14025.4150390625
2022-02-28 19:30:00+00:00,0,21,-21,No Signal,14115.671875
2022-02-28 20:30:00+00:00,0,20,-20,No Signal,14239.0771484375
2022-03-01 14:30:00+00:00,1,19,-18,No Signal,14248.5595703125
2022-03-01 15:30:00+00:00,1,13,-12,No Signal,14148.9130859375
2022-03-01 16:30:00+00:00,8,8,0,No Signal,14066.0869140625
2022-03-01 17:30:00+00:00,9,9,0,No Signal,13984.1298828125
2022-03-01 18:30:00+00:00,6,9,-3,No Signal,14044.0732421875
2022-03-01 19:30:00+00:00,7,4,3,No Signal,13990.6904296875
2022-03-01 20:30:00+00:00,11,3,8,No Signal,14008.1337890625
2022-03-02 14:30:00+00:00,3,6,-3,No Signal,14086.1455078125
2022-03-02 15:30:00+00:00,7,2,5,No Signal,14176.6650390625
2022-03-02 16:30:00+00:00,6,6,0,No Signal,14185.7802734375
2022-03-02 17:30:00+00:00,4,7,-3,No Signal,14246.2841796875
2022-03-02 18:30:00+00:00,2,16,-14,No Signal,14241.9326171875
2022-03-02 19:30:00+00:00,5,12,-7,No Signal,14269.818359375
2022-03-02 20:30:00+00:00,6,8,-2,No Signal,14240.375
2022-03-03 14:30:00+00:00,18,11,7,No Signal,14150.544921875
2022-03-03 15:30:00+00:00,9,10,-1,No Signal,14109.9072265625
2022-03-03 16:30:00+00:00,13,13,0,No Signal,14062.830078125
2022-03-03 17:30:00+00:00,6,24,-18,No Signal,14183.9677734375
2022-03-03 18:30:00+00:00,9,19,-10,No Signal,14150.4716796875
2022-03-03 19:30:00+00:00,10,17,-7,No Signal,14046.2724609375
2022-03-03 20:30:00+00:00,9,14,-5,No Signal,14036.037109375
2022-03-04 14:30:00+00:00,23,3,20,Long,13831.830078125
2022-03-04 15:30:00+00:00,45,4,41,No Signal,13785.8505859375
2022-03-04 16:30:00+00:00,40,6,34,No Signal,13868.9677734375
2022-03-04 17:30:00+00:00,46,7,39,No Signal,13870.509765625
2022-03-04 18:30:00+00:00,47,5,42,No Signal,13817.107421875
2022-03-04 19:30:00+00:00,50,5,45,No Signal,13793.0517578125
2022-03-04 20:30:00+00:00,47,5,42,No Signal,13844.7177734375
2022-03-07 14:30:00+00:00,53,6,47,No Signal,13580.80859375
2022-03-07 15:30:00+00:00,48,5,43,No Signal,13617.9794921875
2022-03-07 16:30:00+00:00,48,6,42,No Signal,13526.5048828125
2022-03-07 17:30:00+00:00,61,5,56,No Signal,13480.3203125
2022-03-07 18:30:00+00:00,63,2,61,No Signal,13484.916015625
2022-03-07 19:30:00+00:00,59,4,55,No Signal,13415.447265625
2022-03-07 20:30:00+00:00,63,3,60,No Signal,13315.4775390625
2022-03-08 14:30:00+00:00,61,3,58,No Signal,13192.21875
2022-03-08 15:30:00+00:00,54,2,52,No Signal,13199.6083984375
2022-03-08 16:30:00+00:00,26,2,24,No Signal,13512.013671875
2022-03-08 17:30:00+00:00,28,2,26,No Signal,13523.2587890625
2022-03-08 18:30:00+00:00,26,2,24,No Signal,13418.626953125
2022-03-08 19:30:00+00:00,28,1,27,No Signal,13350.8701171875
2022-03-08 20:30:00+00:00,39,1,38,No Signal,13270.4404296875
2022-03-09 14:30:00+00:00,8,6,2,No Signal,13631.859375
2022-03-09 15:30:00+00:00,8,2,6,No Signal,13600.6376953125
2022-03-09 16:30:00+00:00,5,6,-1,No Signal,13675.0869140625
2022-03-09 17:30:00+00:00,4,14,-10,Short,13735.419921875
2022-03-09 18:30:00+00:00,4,9,-5,No Signal,13712.91796875
2022-03-09 19:30:00+00:00,0,21,-21,No Signal,13772.06640625
2022-03-09 20:30:00+00:00,2,30,-28,No Signal,13741.1650390625
2022-03-10 14:30:00+00:00,4,15,-11,No Signal,13532.486328125
2022-03-10 15:30:00+00:00,4,10,-6,No Signal,13411.9990234375
2022-03-10 16:30:00+00:00,8,4,4,No Signal,13493.1455078125
2022-03-10 17:30:00+00:00,6,2,4,No Signal,13475.529296875
2022-03-10 18:30:00+00:00,2,10,-8,No Signal,13590.185546875
2022-03-10 19:30:00+00:00,2,10,-8,No Signal,13583.3623046875
2022-03-10 20:30:00+00:00,1,16,-15,No Signal,13589.763671875
2022-03-11 14:30:00+00:00,11,7,4,No Signal,13546.91796875
2022-03-11 15:30:00+00:00,9,7,2,No Signal,13477.2744140625
2022-03-11 16:30:00+00:00,27,4,23,Long,13426.2548828125
2022-03-11 17:30:00+00:00,28,4,24,No Signal,13495.814453125
2022-03-11 18:30:00+00:00,24,5,19,No Signal,13485.6689453125
2022-03-11 19:30:00+00:00,39,5,34,No Signal,13375.6220703125
2022-03-11 20:30:00+00:00,41,0,41,No Signal,13289.55078125
2022-03-14 13:30:00+00:00,18,5,13,No Signal,13341.845703125
2022-03-14 14:30:00+00:00,19,8,11,No Signal,13260.240234375
2022-03-14 15:30:00+00:00,36,4,32,No Signal,13161.74609375
2022-03-14 16:30:00+00:00,41,1,40,No Signal,13051.1318359375
2022-03-14 17:30:00+00:00,56,0,56,No Signal,13038.94140625
2022-03-14 18:30:00+00:00,47,0,47,No Signal,13078.2939453125
2022-03-14 19:30:00+00:00,49,0,49,No Signal,13042.0439453125
2022-03-15 13:30:00+00:00,26,1,25,No Signal,13262.2509765625
2022-03-15 14:30:00+00:00,17,2,15,No Signal,13355.7744140625
2022-03-15 15:30:00+00:00,13,3,10,No Signal,13378.703125
2022-03-15 16:30:00+00:00,17,1,16,No Signal,13299.4189453125
2022-03-15 17:30:00+00:00,16,0,16,No Signal,13298.35546875
2022-03-15 18:30:00+00:00,5,5,0,No Signal,13439.498046875
2022-03-15 19:30:00+00:00,3,9,-6,No Signal,13454.7578125
2022-03-16 13:30:00+00:00,0,30,-30,Short,13827.9423828125
2022-03-16 14:30:00+00:00,0,37,-37,No Signal,13821.7734375
2022-03-16 15:30:00+00:00,3,45,-42,No Signal,13794.3173828125
2022-03-16 16:30:00+00:00,0,49,-49,No Signal,13691.109375
2022-03-16 17:30:00+00:00,1,21,-20,No Signal,13536.751953125
2022-03-16 18:30:00+00:00,0,50,-50,No Signal,13851.0615234375
2022-03-16 19:30:00+00:00,0,63,-63,No Signal,13960.2509765625
2022-03-17 13:30:00+00:00,1,45,-44,No Signal,13954.6376953125
2022-03-17 14:30:00+00:00,0,35,-35,No Signal,13916.51953125
2022-03-17 15:30:00+00:00,0,37,-37,No Signal,13971.6689453125
2022-03-17 16:30:00+00:00,0,59,-59,No Signal,14036.693359375
2022-03-17 17:30:00+00:00,0,56,-56,No Signal,14020.794921875
2022-03-17 18:30:00+00:00,0,40,-40,No Signal,14058.6240234375
2022-03-17 19:30:00+00:00,0,48,-48,No Signal,14115.896484375
2022-03-18 13:30:00+00:00,0,28,-28,No Signal,14215.8408203125
2022-03-18 14:30:00+00:00,0,31,-31,No Signal,14236.2587890625
2022-03-18 15:30:00+00:00,0,39,-39,No Signal,14279.876953125
2022-03-18 16:30:00+00:00,0,54,-54,No Signal,14316.669921875
2022-03-18 17:30:00+00:00,0,69,-69,No Signal,14315.6875
2022-03-18 18:30:00+00:00,0,60,-60,No Signal,14394.9580078125
2022-03-18 19:30:00+00:00,0,57,-57,No Signal,14425.4306640625
2022-03-21 13:30:00+00:00,1,15,-14,No Signal,14235.677734375
2022-03-21 14:30:00+00:00,0,28,-28,No Signal,14436.583984375
2022-03-21 15:30:00+00:00,1,21,-20,No Signal,14410.3330078125
2022-03-21 16:30:00+00:00,2,3,-1,No Signal,14219.8291015625
2022-03-21 17:30:00+00:00,1,5,-4,No Signal,14332.982421875
2022-03-21 18:30:00+00:00,0,4,-4,No Signal,14320.5302734375
2022-03-21 19:30:00+00:00,0,5,-5,No Signal,14377.462890625
2022-03-22 13:30:00+00:00,0,9,-9,No Signal,14589.19921875
2022-03-22 14:30:00+00:00,0,11,-11,No Signal,14673.0224609375
2022-03-22 15:30:00+00:00,0,8,-8,No Signal,14590.9912109375
2022-03-22 16:30:00+00:00,0,8,-8,No Signal,14607.71484375
2022-03-22 17:30:00+00:00,0,3,-3,No Signal,14620.318359375
2022-03-22 18:30:00+00:00,0,2,-2,No Signal,14645.537109375
2022-03-22 19:30:00+00:00,0,1,-1,No Signal,14656.9794921875
2022-03-23 13:30:00+00:00,1,11,-10,No Signal,14581.01953125
2022-03-23 14:30:00+00:00,0,10,-10,No Signal,14631.3017578125
2022-03-23 15:30:00+00:00,1,11,-10,No Signal,14628.646484375
2022-03-23 16:30:00+00:00,1,15,-14,No Signal,14504.638671875
2022-03-23 17:30:00+00:00,4,12,-8,No Signal,14520.0888671875
2022-03-23 18:30:00+00:00,3,11,-8,No Signal,14501.7119140625
2022-03-23 19:30:00+00:00,11,5,6,No Signal,14448.19921875
2022-03-24 13:30:00+00:00,23,4,19,Long,14460.2373046875
2022-03-24 14:30:00+00:00,15,5,10,No Signal,14624.8447265625
2022-03-24 15:30:00+00:00,12,4,8,No Signal,14604.7392578125
2022-03-24 16:30:00+00:00,12,5,7,No Signal,14648.0185546875
2022-03-24 17:30:00+00:00,11,5,6,No Signal,14655.986328125
2022-03-24 18:30:00+00:00,7,8,-1,No Signal,14724.61328125
2022-03-24 19:30:00+00:00,5,8,-3,No Signal,14767.4970703125
2022-03-25 13:30:00+00:00,4,14,-10,Short,14746.8779296875
2022-03-25 14:30:00+00:00,16,3,13,Long,14598.3193359375
2022-03-25 15:30:00+00:00,8,8,0,No Signal,14653.3154296875
2022-03-25 16:30:00+00:00,3,14,-11,Short,14655.6201171875
2022-03-25 17:30:00+00:00,3,18,-15,No Signal,14726.1181640625
2022-03-25 18:30:00+00:00,6,11,-5,No Signal,14648.3056640625
2022-03-25 19:30:00+00:00,2,24,-22,No Signal,14759.3642578125
2022-03-28 13:30:00+00:00,1,14,-13,No Signal,14819.34375
2022-03-28 14:30:00+00:00,1,9,-8,No Signal,14828.361328125
2022-03-28 15:30:00+00:00,2,8,-6,No Signal,14729.9208984375
2022-03-28 16:30:00+00:00,1,9,-8,No Signal,14837.791015625
2022-03-28 17:30:00+00:00,2,10,-8,No Signal,14865.158203125
2022-03-28 18:30:00+00:00,2,10,-8,No Signal,14946.1005859375
2022-03-28 19:30:00+00:00,2,10,-8,No Signal,14987.0390625
2022-03-29 13:30:00+00:00,0,21,-21,No Signal,15092.71484375
2022-03-29 14:30:00+00:00,0,61,-61,No Signal,15140.3896484375
2022-03-29 15:30:00+00:00,1,52,-51,No Signal,15120.1357421875
2022-03-29 16:30:00+00:00,1,49,-48,No Signal,15117.5927734375
2022-03-29 17:30:00+00:00,0,48,-48,No Signal,15181.6953125
2022-03-29 18:30:00+00:00,0,63,-63,No Signal,15253.4970703125
2022-03-29 19:30:00+00:00,0,55,-55,No Signal,15239.5869140625
2022-03-30 13:30:00+00:00,0,48,-48,No Signal,15212.103515625
2022-03-30 14:30:00+00:00,0,34,-34,No Signal,15111.4658203125
2022-03-30 15:30:00+00:00,1,53,-52,No Signal,15157.181640625
2022-03-30 16:30:00+00:00,1,41,-40,No Signal,15156.3984375
2022-03-30 17:30:00+00:00,0,27,-27,No Signal,15103.0205078125
2022-03-30 18:30:00+00:00,0,14,-14,No Signal,15030.3798828125
2022-03-30 19:30:00+00:00,2,14,-12,No Signal,15067.69921875
2022-03-31 13:30:00+00:00,15,13,2,No Signal,15011.802734375
2022-03-31 14:30:00+00:00,16,17,-1,No Signal,15026.5654296875
2022-03-31 15:30:00+00:00,16,14,2,No Signal,14998.8486328125
2022-03-31 16:30:00+00:00,12,16,-4,No Signal,15003.326171875
2022-03-31 17:30:00+00:00,30,12,18,Long,14989.3779296875
2022-03-31 18:30:00+00:00,34,6,28,No Signal,14982.4443359375
2022-03-31 19:30:00+00:00,45,1,44,No Signal,14838.107421875
2022-04-01 13:30:00+00:00,33,0,33,No Signal,14833.626953125
2022-04-01 14:30:00+00:00,27,1,26,No Signal,14826.69140625
2022-04-01 15:30:00+00:00,37,1,36,No Signal,14777.3896484375
2022-04-01 16:30:00+00:00,38,1,37,No Signal,14739.2421875
2022-04-01 17:30:00+00:00,25,1,24,No Signal,14817.1279296875
2022-04-01 18:30:00+00:00,22,4,18,No Signal,14775.9716796875
2022-04-01 19:30:00+00:00,14,3,11,No Signal,14858.98828125
2022-04-04 13:30:00+00:00,7,11,-4,No Signal,15038.4638671875
2022-04-04 14:30:00+00:00,9,10,-1,No Signal,15090.4814453125
2022-04-04 15:30:00+00:00,7,16,-9,No Signal,15117.244140625
2022-04-04 16:30:00+00:00,9,16,-7,No Signal,15100.4091796875
2022-04-04 17:30:00+00:00,9,15,-6,No Signal,15106.7587890625
2022-04-04 18:30:00+00:00,4,17,-13,Short,15138.845703125
2022-04-04 19:30:00+00:00,3,33,-30,No Signal,15161.01953125
2022-04-05 13:30:00+00:00,9,14,-5,No Signal,14960.4736328125
2022-04-05 14:30:00+00:00,10,17,-7,No Signal,14933.9775390625
2022-04-05 15:30:00+00:00,8,13,-5,No Signal,14852.3154296875
2022-04-05 16:30:00+00:00,4,14,-10,No Signal,14914.4521484375
2022-04-05 17:30:00+00:00,6,9,-3,No Signal,14882.3623046875
2022-04-05 18:30:00+00:00,8,5,3,No Signal,14819.2646484375
2022-04-05 19:30:00+00:00,8,2,6,No Signal,14825.3212890625
2022-04-06 13:30:00+00:00,56,5,51,Long,14463.427734375
2022-04-06 14:30:00+00:00,57,4,53,No Signal,14475.2783203125
2022-04-06 15:30:00+00:00,61,8,53,No Signal,14428.8173828125
2022-04-06 16:30:00+00:00,49,11,38,No Signal,14475.111328125
2022-04-06 17:30:00+00:00,54,6,48,No Signal,14434.5380859375
2022-04-06 18:30:00+00:00,53,6,47,No Signal,14486.33984375
2022-04-06 19:30:00+00:00,50,8,42,No Signal,14493.0908203125
2022-04-07 13:30:00+00:00,36,4,32,No Signal,14516.763671875
2022-04-07 14:30:00+00:00,42,4,38,No Signal,14413.8115234375
2022-04-07 15:30:00+00:00,38,4,34,No Signal,14375.244140625
2022-04-07 16:30:00+00:00,33,6,27,No Signal,14458.259765625
2022-04-07 17:30:00+00:00,28,8,20,No Signal,14484.7568359375
2022-04-07 18:30:00+00:00,13,7,6,No Signal,14569.9921875
2022-04-07 19:30:00+00:00,17,10,7,No Signal,14526.966796875
2022-04-08 13:30:00+00:00,1,12,-11,Short,14404.37109375
2022-04-08 14:30:00+00:00,1,13,-12,No Signal,14423.6220703125
2022-04-08 15:30:00+00:00,3,15,-12,No Signal,14486.08984375
2022-04-08 16:30:00+00:00,3,10,-7,No Signal,14413.8828125
2022-04-08 17:30:00+00:00,3,13,-10,No Signal,14353.0283203125
2022-04-08 18:30:00+00:00,5,10,-5,No Signal,14379.35546875
2022-04-08 19:30:00+00:00,9,8,1,No Signal,14330.8056640625
2022-04-11 13:30:00+00:00,34,7,27,Long,14070.2392578125
2022-04-11 14:30:00+00:00,18,9,9,No Signal,14052.1845703125
2022-04-11 15:30:00+00:00,16,8,8,No Signal,14047.0048828125
2022-04-11 16:30:00+00:00,20,3,17,No Signal,14088.1884765625
2022-04-11 17:30:00+00:00,29,1,28,No Signal,14057.5400390625
2022-04-11 18:30:00+00:00,45,1,44,No Signal,14037.8779296875
2022-04-11 19:30:00+00:00,50,2,48,No Signal,13992.560546875
2022-04-12 13:30:00+00:00,11,3,8,No Signal,14186.5849609375
2022-04-12 14:30:00+00:00,16,1,15,No Signal,14169.9765625
2022-04-12 15:30:00+00:00,24,1,23,No Signal,14072.8427734375
2022-04-12 16:30:00+00:00,22,2,20,No Signal,14080.3544921875
2022-04-12 17:30:00+00:00,26,2,24,No Signal,13931.28515625
2022-04-12 18:30:00+00:00,35,1,34,No Signal,13893.5625
2022-04-12 19:30:00+00:00,26,1,25,No Signal,13941.193359375
2022-04-13 13:30:00+00:00,5,3,2,No Signal,14070.1689453125
2022-04-13 14:30:00+00:00,4,8,-4,No Signal,14152.6123046875
2022-04-13 15:30:00+00:00,6,6,0,No Signal,14161.3310546875
2022-04-13 16:30:00+00:00,5,6,-1,No Signal,14177.6005859375
2022-04-13 17:30:00+00:00,3,8,-5,No Signal,14171.669921875
2022-04-13 18:30:00+00:00,1,9,-8,No Signal,14237.8330078125
2022-04-13 19:30:00+00:00,0,11,-11,Short,14218.263671875
2022-04-14 13:30:00+00:00,5,6,-1,No Signal,14066.71484375
2022-04-14 14:30:00+00:00,5,4,1,No Signal,14074.392578125
2022-04-14 15:30:00+00:00,4,7,-3,No Signal,13986.6376953125
2022-04-14 16:30:00+00:00,4,9,-5,No Signal,13977.1103515625
2022-04-14 17:30:00+00:00,1,17,-16,No Signal,14007.7607421875
2022-04-14 18:30:00+00:00,2,15,-13,No Signal,13931.421875
2022-04-14 19:30:00+00:00,3,11,-8,No Signal,13892.5634765625
2022-04-18 13:30:00+00:00,16,3,13,Long,13976.67578125
2022-04-18 14:30:00+00:00,35,2,33,No Signal,13876.7724609375
2022-04-18 15:30:00+00:00,46,1,45,No Signal,13794.6240234375
2022-04-18 16:30:00+00:00,39,1,38,No Signal,13855.5263671875
2022-04-18 17:30:00+00:00,26,3,23,No Signal,13963.9951171875
2022-04-18 18:30:00+00:00,43,1,42,No Signal,13892.2431640625
2022-04-18 19:30:00+00:00,34,1,33,No Signal,13909.296875
2022-04-19 13:30:00+00:00,6,2,4,No Signal,14076.8916015625
2022-04-19 14:30:00+00:00,4,4,0,No Signal,14165.314453125
2022-04-19 15:30:00+00:00,4,8,-4,No Signal,14149.357421875
2022-04-19 16:30:00+00:00,5,7,-2,No Signal,14125.609375
2022-04-19 17:30:00+00:00,5,4,1,No Signal,14123.1923828125
2022-04-19 18:30:00+00:00,3,18,-15,Short,14213.8193359375
2022-04-19 19:30:00+00:00,2,27,-25,No Signal,14214.7900390625
2022-04-20 13:30:00+00:00,1,33,-32,No Signal,14100.8603515625
2022-04-20 14:30:00+00:00,1,35,-34,No Signal,14039.154296875
2022-04-20 15:30:00+00:00,1,45,-44,No Signal,13995.03515625
2022-04-20 16:30:00+00:00,1,45,-44,No Signal,14074.3134765625
2022-04-20 17:30:00+00:00,5,34,-29,No Signal,14031.1435546875
2022-04-20 18:30:00+00:00,4,40,-36,No Signal,14025.6845703125
2022-04-20 19:30:00+00:00,6,34,-28,No Signal,13996.0205078125
2022-04-21 13:30:00+00:00,11,31,-20,No Signal,14167.8466796875
2022-04-21 14:30:00+00:00,20,17,3,No Signal,14083.5146484375
2022-04-21 15:30:00+00:00,26,12,14,Long,13938.3701171875
2022-04-21 16:30:00+00:00,26,15,11,No Signal,13934.91015625
2022-04-21 17:30:00+00:00,32,11,21,No Signal,13805.3193359375
2022-04-21 18:30:00+00:00,38,4,34,No Signal,13761.9482421875
2022-04-21 19:30:00+00:00,40,2,38,No Signal,13727.2998046875
2022-04-22 13:30:00+00:00,61,1,60,No Signal,13588.6259765625
2022-04-22 14:30:00+00:00,51,1,50,No Signal,13613.705078125
2022-04-22 15:30:00+00:00,58,0,58,No Signal,13514.0615234375
2022-04-22 16:30:00+00:00,65,2,63,No Signal,13474.4150390625
2022-04-22 17:30:00+00:00,71,0,71,No Signal,13443.60546875
2022-04-22 18:30:00+00:00,73,2,71,No Signal,13434.0341796875
2022-04-22 19:30:00+00:00,75,1,74,No Signal,13355.7021484375
2022-04-25 13:30:00+00:00,72,1,71,No Signal,13393.6083984375
2022-04-25 14:30:00+00:00,71,1,70,No Signal,13308.7197265625
2022-04-25 15:30:00+00:00,54,2,52,No Signal,13344.4453125
2022-04-25 16:30:00+00:00,53,0,53,No Signal,13377.9033203125
2022-04-25 17:30:00+00:00,32,3,29,No Signal,13441.943359375
2022-04-25 18:30:00+00:00,22,0,22,No Signal,13477.978515625
2022-04-25 19:30:00+00:00,11,3,8,No Signal,13535.0693359375
2022-04-26 13:30:00+00:00,16,0,16,No Signal,13198.640625
2022-04-26 14:30:00+00:00,26,1,25,No Signal,13147.0888671875
2022-04-26 15:30:00+00:00,12,2,10,No Signal,13211.080078125
2022-04-26 16:30:00+00:00,19,4,15,No Signal,13108.916015625
2022-04-26 17:30:00+00:00,10,1,9,No Signal,13174.0244140625
2022-04-26 18:30:00+00:00,15,0,15,No Signal,13078.443359375
2022-04-26 19:30:00+00:00,14,0,14,No Signal,13010.1435546875
2022-04-27 13:30:00+00:00,28,4,24,No Signal,12975.7822265625
2022-04-27 14:30:00+00:00,10,6,4,No Signal,13106.2001953125
2022-04-27 15:30:00+00:00,5,4,1,No Signal,13209.140625
2022-04-27 16:30:00+00:00,8,4,4,No Signal,13158.2666015625
2022-04-27 17:30:00+00:00,15,2,13,No Signal,13112.65234375
2022-04-27 18:30:00+00:00,21,3,18,No Signal,13025.6953125
2022-04-27 19:30:00+00:00,46,1,45,No Signal,12999.7216796875
2022-04-28 13:30:00+00:00,21,2,19,No Signal,13072.5068359375
2022-04-28 14:30:00+00:00,14,4,10,No Signal,13178.662109375
2022-04-28 15:30:00+00:00,7,5,2,No Signal,13253.29296875
2022-04-28 16:30:00+00:00,4,14,-10,Short,13410.2294921875
2022-04-28 17:30:00+00:00,4,16,-12,No Signal,13457.2783203125
2022-04-28 18:30:00+00:00,2,35,-33,No Signal,13506.8818359375
2022-04-28 19:30:00+00:00,2,43,-41,No Signal,13467.1416015625
2022-04-29 13:30:00+00:00,4,29,-25,No Signal,13233.15234375
2022-04-29 14:30:00+00:00,6,21,-15,No Signal,13198.025390625
2022-04-29 15:30:00+00:00,8,10,-2,No Signal,13120.541015625
2022-04-29 16:30:00+00:00,8,10,-2,No Signal,13108.541015625
2022-04-29 17:30:00+00:00,10,7,3,No Signal,13021.59375
2022-04-29 18:30:00+00:00,10,6,4,No Signal,12940.9697265625
2022-04-29 19:30:00+00:00,11,5,6,No Signal,12858.0693359375
2022-05-02 13:30:00+00:00,3,6,-3,No Signal,12984.37109375
2022-05-02 14:30:00+00:00,13,3,10,Long,12862.3232421875
2022-05-02 15:30:00+00:00,22,4,18,No Signal,12913.3583984375
2022-05-02 16:30:00+00:00,42,2,40,No Signal,12796.435546875
2022-05-02 17:30:00+00:00,60,2,58,No Signal,12749.5771484375
2022-05-02 18:30:00+00:00,28,2,26,No Signal,12967.7236328125
2022-05-02 19:30:00+00:00,22,2,20,No Signal,13075.212890625
2022-05-03 13:30:00+00:00,9,0,9,No Signal,13070.646484375
2022-05-03 14:30:00+00:00,8,0,8,No Signal,13111.4599609375
2022-05-03 15:30:00+00:00,9,1,8,No Signal,13060.4501953125
2022-05-03 16:30:00+00:00,8,0,8,No Signal,13132.2353515625
2022-05-03 17:30:00+00:00,9,1,8,No Signal,13038.4365234375
2022-05-03 18:30:00+00:00,3,2,1,No Signal,13088.1298828125
2022-05-03 19:30:00+00:00,0,6,-6,No Signal,13085.984375
2022-05-04 13:30:00+00:00,9,3,6,No Signal,12962.9775390625
2022-05-04 14:30:00+00:00,8,5,3,No Signal,12909.646484375
2022-05-04 15:30:00+00:00,3,5,-2,No Signal,13059.8642578125
2022-05-04 16:30:00+00:00,1,16,-15,Short,13098.71484375
2022-05-04 17:30:00+00:00,1,28,-27,No Signal,13130.5205078125
2022-05-04 18:30:00+00:00,0,36,-36,No Signal,13466.5078125
2022-05-04 19:30:00+00:00,0,35,-35,No Signal,13534.5791015625
2022-05-05 13:30:00+00:00,3,6,-3,No Signal,13021.083984375
2022-05-05 14:30:00+00:00,3,1,2,No Signal,12914.92578125
2022-05-05 15:30:00+00:00,3,2,1,No Signal,12909.1826171875
2022-05-05 16:30:00+00:00,3,1,2,No Signal,12904.6376953125
2022-05-05 17:30:00+00:00,3,1,2,No Signal,12797.068359375
2022-05-05 18:30:00+00:00,6,2,4,No Signal,12729.30859375
2022-05-05 19:30:00+00:00,3,1,2,No Signal,12869.03515625
2022-05-06 13:30:00+00:00,2,2,0,No Signal,12719.82421875
2022-05-06 14:30:00+00:00,3,2,1,No Signal,12883.734375
2022-05-06 15:30:00+00:00,4,2,2,No Signal,12793.6162109375
2022-05-06 16:30:00+00:00,11,3,8,No Signal,12779.353515625
2022-05-06 17:30:00+00:00,16,0,16,Long,12656.333984375
2022-05-06 18:30:00+00:00,71,2,69,No Signal,12616.109375
2022-05-06 19:30:00+00:00,64,0,64,No Signal,12692.318359375
2022-05-09 13:30:00+00:00,55,0,55,No Signal,12349.296875
2022-05-09 14:30:00+00:00,52,1,51,No Signal,12277.84765625
2022-05-09 15:30:00+00:00,37,1,36,No Signal,12376.13671875
2022-05-09 16:30:00+00:00,45,1,44,No Signal,12317.12109375
2022-05-09 17:30:00+00:00,40,2,38,No Signal,12237.10546875
2022-05-09 18:30:00+00:00,37,5,32,No Signal,12231.3173828125
2022-05-09 19:30:00+00:00,62,0,62,No Signal,12193.9609375
2022-05-10 13:30:00+00:00,15,5,10,No Signal,12417.1005859375
2022-05-10 14:30:00+00:00,52,1,51,No Signal,12221.1494140625
2022-05-10 15:30:00+00:00,45,1,44,No Signal,12241.45703125
2022-05-10 16:30:00+00:00,24,2,22,No Signal,12338.517578125
2022-05-10 17:30:00+00:00,7,0,7,No Signal,12422.1142578125
2022-05-10 18:30:00+00:00,7,0,7,No Signal,12393.0
2022-05-10 19:30:00+00:00,16,0,16,No Signal,12346.916015625
2022-05-11 13:30:00+00:00,1,4,-3,No Signal,12386.6103515625
2022-05-11 14:30:00+00:00,2,5,-3,No Signal,12315.451171875
2022-05-11 15:30:00+00:00,9,1,8,No Signal,12210.2724609375
2022-05-11 16:30:00+00:00,12,1,11,No Signal,12092.966796875
2022-05-11 17:30:00+00:00,9,1,8,No Signal,12082.8984375
2022-05-11 18:30:00+00:00,11,1,10,No Signal,12012.0517578125
2022-05-11 19:30:00+00:00,11,2,9,No Signal,11971.787109375
2022-05-12 13:30:00+00:00,18,1,17,No Signal,11979.2607421875
2022-05-12 14:30:00+00:00,6,2,4,No Signal,12037.658203125
2022-05-12 15:30:00+00:00,10,3,7,No Signal,11905.6767578125
2022-05-12 16:30:00+00:00,22,2,20,No Signal,11849.9501953125
2022-05-12 17:30:00+00:00,45,1,44,No Signal,11756.140625
2022-05-12 18:30:00+00:00,37,1,36,No Signal,11821.158203125
2022-05-12 19:30:00+00:00,21,3,18,No Signal,11949.697265625
2022-05-13 13:30:00+00:00,0,3,-3,No Signal,12323.82421875
2022-05-13 14:30:00+00:00,0,5,-5,No Signal,12346.5888671875
2022-05-13 15:30:00+00:00,0,13,-13,Short,12396.462890625
2022-05-13 16:30:00+00:00,0,21,-21,No Signal,12361.1103515625
2022-05-13 17:30:00+00:00,0,15,-15,No Signal,12248.46875
2022-05-13 18:30:00+00:00,0,37,-37,No Signal,12420.1943359375
2022-05-13 19:30:00+00:00,0,41,-41,No Signal,12384.169921875
2022-05-16 13:30:00+00:00,0,33,-33,No Signal,12358.7568359375
2022-05-16 14:30:00+00:00,0,10,-10,No Signal,12230.8564453125
2022-05-16 15:30:00+00:00,0,19,-19,No Signal,12273.9921875
2022-05-16 16:30:00+00:00,0,27,-27,No Signal,12319.7392578125
2022-05-16 17:30:00+00:00,1,52,-51,No Signal,12376.43359375
2022-05-16 18:30:00+00:00,0,25,-25,No Signal,12275.86328125
2022-05-16 19:30:00+00:00,0,12,-12,No Signal,12246.0224609375
2022-05-17 13:30:00+00:00,6,6,0,No Signal,12406.97265625
2022-05-17 14:30:00+00:00,3,5,-2,No Signal,12436.5068359375
2022-05-17 15:30:00+00:00,5,7,-2,No Signal,12472.6748046875
2022-05-17 16:30:00+00:00,4,9,-5,No Signal,12487.5068359375
2022-05-17 17:30:00+00:00,5,8,-3,No Signal,12423.275390625
2022-05-17 18:30:00+00:00,9,5,4,No Signal,12559.2685546875
2022-05-17 19:30:00+00:00,7,7,0,No Signal,12566.5
2022-05-18 13:30:00+00:00,14,3,11,Long,12305.8310546875
2022-05-18 14:30:00+00:00,10,5,5,No Signal,12149.0576171875
2022-05-18 15:30:00+00:00,12,4,8,No Signal,12076.044921875
2022-05-18 16:30:00+00:00,18,4,14,No Signal,12018.673828125
2022-05-18 17:30:00+00:00,28,1,27,No Signal,11991.9853515625
2022-05-18 18:30:00+00:00,24,0,24,No Signal,11914.1171875
2022-05-18 19:30:00+00:00,21,0,21,No Signal,11933.4814453125
2022-05-19 13:30:00+00:00,32,2,30,No Signal,11912.5390625
2022-05-19 14:30:00+00:00,30,2,28,No Signal,11941.220703125
2022-05-19 15:30:00+00:00,27,3,24,No Signal,12012.9287109375
2022-05-19 16:30:00+00:00,35,3,32,No Signal,11890.9072265625
2022-05-19 17:30:00+00:00,22,2,20,No Signal,11936.44140625
2022-05-19 18:30:00+00:00,44,0,44,No Signal,11890.2314453125
2022-05-19 19:30:00+00:00,45,0,45,No Signal,11875.7744140625
2022-05-20 13:30:00+00:00,23,3,20,No Signal,11944.2724609375
2022-05-20 14:30:00+00:00,25,2,23,No Signal,11760.064453125
2022-05-20 15:30:00+00:00,24,1,23,No Signal,11642.4072265625
2022-05-20 16:30:00+00:00,29,1,28,No Signal,11498.0185546875
2022-05-20 17:30:00+00:00,20,1,19,No Signal,11556.8857421875
2022-05-20 18:30:00+00:00,5,3,2,No Signal,11671.2734375
2022-05-20 19:30:00+00:00,1,4,-3,No Signal,11835.8447265625
2022-05-23 13:30:00+00:00,0,11,-11,Short,11880.7255859375
2022-05-23 14:30:00+00:00,1,13,-12,No Signal,11948.9931640625
2022-05-23 15:30:00+00:00,0,10,-10,No Signal,12011.462890625
2022-05-23 16:30:00+00:00,0,8,-8,No Signal,11952.3427734375
2022-05-23 17:30:00+00:00,0,6,-6,No Signal,12009.7705078125
2022-05-23 18:30:00+00:00,0,6,-6,No Signal,11983.7734375
2022-05-23 19:30:00+00:00,0,8,-8,No Signal,12030.6591796875
2022-05-24 13:30:00+00:00,10,4,6,No Signal,11648.927734375
2022-05-24 14:30:00+00:00,2,5,-3,No Signal,11655.8671875
2022-05-24 15:30:00+00:00,0,12,-12,No Signal,11730.794921875
2022-05-24 16:30:00+00:00,0,17,-17,No Signal,11676.619140625
2022-05-24 17:30:00+00:00,1,18,-17,No Signal,11734.19140625
2022-05-24 18:30:00+00:00,6,14,-8,No Signal,11728.265625
2022-05-24 19:30:00+00:00,11,9,2,No Signal,11778.6533203125
2022-05-25 13:30:00+00:00,4,6,-2,No Signal,11883.978515625
2022-05-25 14:30:00+00:00,2,6,-4,No Signal,11868.734375
2022-05-25 15:30:00+00:00,12,4,8,No Signal,11806.3369140625
2022-05-25 16:30:00+00:00,7,7,0,No Signal,11829.4443359375
2022-05-25 17:30:00+00:00,6,6,0,No Signal,11934.73828125
2022-05-25 18:30:00+00:00,1,10,-9,No Signal,11990.4228515625
2022-05-25 19:30:00+00:00,4,8,-4,No Signal,11941.9072265625
2022-05-26 13:30:00+00:00,0,59,-59,No Signal,12154.8232421875
2022-05-26 14:30:00+00:00,0,62,-62,No Signal,12203.6591796875
2022-05-26 15:30:00+00:00,0,60,-60,No Signal,12300.80859375
2022-05-26 16:30:00+00:00,0,68,-68,No Signal,12287.3017578125
2022-05-26 17:30:00+00:00,0,65,-65,No Signal,12313.7236328125
2022-05-26 18:30:00+00:00,0,55,-55,No Signal,12258.0625
2022-05-26 19:30:00+00:00,1,52,-51,No Signal,12272.0693359375
2022-05-27 13:30:00+00:00,0,69,-69,No Signal,12560.345703125
2022-05-27 14:30:00+00:00,0,71,-71,No Signal,12559.875
2022-05-27 15:30:00+00:00,0,73,-73,No Signal,12579.486328125
2022-05-27 16:30:00+00:00,0,74,-74,No Signal,12586.748046875
2022-05-27 17:30:00+00:00,0,68,-68,No Signal,12594.81640625
2022-05-27 18:30:00+00:00,1,68,-67,No Signal,12654.9072265625
2022-05-27 19:30:00+00:00,0,74,-74,No Signal,12680.576171875
2022-05-31 13:30:00+00:00,3,37,-34,No Signal,12567.0498046875
2022-05-31 14:30:00+00:00,2,35,-33,No Signal,12591.14453125
2022-05-31 15:30:00+00:00,1,34,-33,No Signal,12700.3642578125
2022-05-31 16:30:00+00:00,2,31,-29,No Signal,12674.0947265625
2022-05-31 17:30:00+00:00,0,28,-28,No Signal,12730.6806640625
2022-05-31 18:30:00+00:00,1,35,-34,No Signal,12709.7685546875
2022-05-31 19:30:00+00:00,1,26,-25,No Signal,12648.7734375
2022-06-01 13:30:00+00:00,12,7,5,No Signal,12617.3349609375
2022-06-01 14:30:00+00:00,17,2,15,Long,12553.6806640625
2022-06-01 15:30:00+00:00,23,1,22,No Signal,12487.1943359375
2022-06-01 16:30:00+00:00,18,2,16,No Signal,12523.3740234375
2022-06-01 17:30:00+00:00,10,2,8,No Signal,12630.87890625
2022-06-01 18:30:00+00:00,16,2,14,No Signal,12624.03515625
2022-06-01 19:30:00+00:00,23,2,21,No Signal,12546.861328125
2022-06-02 13:30:00+00:00,11,2,9,No Signal,12518.7353515625
2022-06-02 14:30:00+00:00,6,7,-1,No Signal,12671.3974609375
2022-06-02 15:30:00+00:00,5,8,-3,No Signal,12763.6982421875
2022-06-02 16:30:00+00:00,3,11,-8,No Signal,12796.54296875
2022-06-02 17:30:00+00:00,3,11,-8,No Signal,12844.576171875
2022-06-02 18:30:00+00:00,3,14,-11,Short,12815.8173828125
2022-06-02 19:30:00+00:00,2,21,-19,No Signal,12893.4560546875
2022-06-03 13:30:00+00:00,1,11,-10,No Signal,12635.3056640625
2022-06-03 14:30:00+00:00,2,8,-6,No Signal,12518.9609375
2022-06-03 15:30:00+00:00,0,12,-12,No Signal,12569.1357421875
2022-06-03 16:30:00+00:00,0,12,-12,No Signal,12575.5830078125
2022-06-03 17:30:00+00:00,0,8,-8,No Signal,12596.7568359375
2022-06-03 18:30:00+00:00,2,6,-4,No Signal,12546.2158203125
2022-06-03 19:30:00+00:00,1,12,-11,No Signal,12545.8974609375
2022-06-06 13:30:00+00:00,0,23,-23,No Signal,12782.0380859375
2022-06-06 14:30:00+00:00,2,6,-4,No Signal,12655.734375
2022-06-06 15:30:00+00:00,4,2,2,No Signal,12557.2939453125
2022-06-06 16:30:00+00:00,8,2,6,No Signal,12582.091796875
2022-06-06 17:30:00+00:00,14,1,13,Long,12594.728515625
2022-06-06 18:30:00+00:00,16,1,15,No Signal,12563.50390625
2022-06-06 19:30:00+00:00,22,1,21,No Signal,12599.6650390625
2022-06-07 13:30:00+00:00,12,5,7,No Signal,12588.9130859375
2022-06-07 14:30:00+00:00,6,12,-6,No Signal,12597.7685546875
2022-06-07 15:30:00+00:00,9,8,1,No Signal,12582.7724609375
2022-06-07 16:30:00+00:00,3,9,-6,No Signal,12650.236328125
2022-06-07 17:30:00+00:00,3,11,-8,No Signal,12686.8740234375
2022-06-07 18:30:00+00:00,3,13,-10,Short,12689.3037109375
2022-06-07 19:30:00+00:00,0,14,-14,No Signal,12708.6630859375
2022-06-08 13:30:00+00:00,9,9,0,No Signal,12726.22265625
2022-06-08 14:30:00+00:00,5,23,-18,No Signal,12758.49609375
2022-06-08 15:30:00+00:00,3,25,-22,No Signal,12684.6181640625
2022-06-08 16:30:00+00:00,7,16,-9,No Signal,12624.734375
2022-06-08 17:30:00+00:00,9,13,-4,No Signal,12604.5849609375
2022-06-08 18:30:00+00:00,4,17,-13,No Signal,12632.912109375
2022-06-08 19:30:00+00:00,8,13,-5,No Signal,12614.0908203125
2022-06-09 13:30:00+00:00,5,7,-2,No Signal,12640.556640625
2022-06-09 14:30:00+00:00,9,1,8,No Signal,12557.0625
2022-06-09 15:30:00+00:00,4,2,2,No Signal,12565.865234375
2022-06-09 16:30:00+00:00,15,1,14,Long,12549.1845703125
2022-06-09 17:30:00+00:00,31,1,30,No Signal,12505.578125
2022-06-09 18:30:00+00:00,47,0,47,No Signal,12366.5791015625
2022-06-09 19:30:00+00:00,59,0,59,No Signal,12269.08203125
2022-06-10 13:30:00+00:00,81,0,81,No Signal,11872.41796875
2022-06-10 14:30:00+00:00,86,0,86,No Signal,11836.708984375
2022-06-10 15:30:00+00:00,84,0,84,No Signal,11854.296875
2022-06-10 16:30:00+00:00,75,1,74,No Signal,11880.615234375
2022-06-10 17:30:00+00:00,72,0,72,No Signal,11892.7216796875
2022-06-10 18:30:00+00:00,74,0,74,No Signal,11945.8505859375
2022-06-10 19:30:00+00:00,81,0,81,No Signal,11832.4609375
2022-06-13 13:30:00+00:00,91,1,90,No Signal,11394.552734375
2022-06-13 14:30:00+00:00,91,0,91,No Signal,11387.37890625
2022-06-13 15:30:00+00:00,89,0,89,No Signal,11442.3154296875
2022-06-13 16:30:00+00:00,90,0,90,No Signal,11390.880859375
2022-06-13 17:30:00+00:00,89,0,89,No Signal,11395.138671875
2022-06-13 18:30:00+00:00,89,0,89,No Signal,11300.6552734375
2022-06-13 19:30:00+00:00,86,0,86,No Signal,11290.46875
2022-06-14 13:30:00+00:00,67,0,67,No Signal,11268.6240234375
2022-06-14 14:30:00+00:00,60,0,60,No Signal,11295.1025390625
2022-06-14 15:30:00+00:00,59,1,58,No Signal,11305.7216796875
2022-06-14 16:30:00+00:00,55,0,55,No Signal,11370.1328125
2022-06-14 17:30:00+00:00,62,1,61,No Signal,11324.0068359375
2022-06-14 18:30:00+00:00,76,0,76,No Signal,11270.6943359375
2022-06-14 19:30:00+00:00,58,0,58,No Signal,11310.61328125
2022-06-15 13:30:00+00:00,3,9,-6,No Signal,11487.515625
2022-06-15 14:30:00+00:00,5,12,-7,No Signal,11467.978515625
2022-06-15 15:30:00+00:00,5,9,-4,No Signal,11528.1025390625
2022-06-15 16:30:00+00:00,3,10,-7,No Signal,11507.0087890625
2022-06-15 17:30:00+00:00,4,7,-3,No Signal,11435.83203125
2022-06-15 18:30:00+00:00,0,36,-36,Short,11696.2587890625
2022-06-15 19:30:00+00:00,0,14,-14,No Signal,11592.091796875
2022-06-16 13:30:00+00:00,1,0,1,No Signal,11208.7119140625
2022-06-16 14:30:00+00:00,3,2,1,No Signal,11186.2734375
2022-06-16 15:30:00+00:00,2,3,-1,No Signal,11159.7275390625
2022-06-16 16:30:00+00:00,4,1,3,No Signal,11183.6396484375
2022-06-16 17:30:00+00:00,7,1,6,No Signal,11064.2197265625
2022-06-16 18:30:00+00:00,3,1,2,No Signal,11130.9609375
2022-06-16 19:30:00+00:00,3,0,3,No Signal,11126.61328125
2022-06-17 13:30:00+00:00,20,2,18,Long,11162.900390625
2022-06-17 14:30:00+00:00,7,0,7,No Signal,11254.8115234375
2022-06-17 15:30:00+00:00,13,2,11,No Signal,11226.46484375
2022-06-17 16:30:00+00:00,5,0,5,No Signal,11315.10546875
2022-06-17 17:30:00+00:00,3,2,1,No Signal,11320.1826171875
2022-06-17 18:30:00+00:00,31,0,31,No Signal,11312.1953125
2022-06-17 19:30:00+00:00,27,2,25,No Signal,11261.708984375
2022-06-21 13:30:00+00:00,1,33,-32,Short,11597.34375
2022-06-21 14:30:00+00:00,0,38,-38,No Signal,11609.7705078125
2022-06-21 15:30:00+00:00,1,34,-33,No Signal,11568.2275390625
2022-06-21 16:30:00+00:00,1,34,-33,No Signal,11579.1494140625
2022-06-21 17:30:00+00:00,1,56,-55,No Signal,11561.56640625
2022-06-21 18:30:00+00:00,0,51,-51,No Signal,11575.8515625
2022-06-21 19:30:00+00:00,1,47,-46,No Signal,11545.9599609375
2022-06-22 13:30:00+00:00,2,60,-58,No Signal,11670.1611328125
2022-06-22 14:30:00+00:00,3,47,-44,No Signal,11642.046875
2022-06-22 15:30:00+00:00,2,36,-34,No Signal,11581.1650390625
2022-06-22 16:30:00+00:00,2,32,-30,No Signal,11629.9404296875
2022-06-22 17:30:00+00:00,2,34,-32,No Signal,11633.322265625
2022-06-22 18:30:00+00:00,3,20,-17,No Signal,11568.4931640625
2022-06-22 19:30:00+00:00,3,24,-21,No Signal,11530.8779296875
2022-06-23 13:30:00+00:00,15,20,-5,No Signal,11617.0341796875
2022-06-23 14:30:00+00:00,10,21,-11,No Signal,11676.37890625
2022-06-23 15:30:00+00:00,14,21,-7,No Signal,11601.0
2022-06-23 16:30:00+00:00,21,15,6,No Signal,11543.3173828125
2022-06-23 17:30:00+00:00,16,26,-10,No Signal,11609.392578125
2022-06-23 18:30:00+00:00,11,27,-16,No Signal,11660.8916015625
2022-06-23 19:30:00+00:00,10,30,-20,No Signal,11698.7158203125
2022-06-24 13:30:00+00:00,0,41,-41,No Signal,12011.544921875
2022-06-24 14:30:00+00:00,0,32,-32,No Signal,11969.5712890625
2022-06-24 15:30:00+00:00,0,47,-47,No Signal,11979.9599609375
2022-06-24 16:30:00+00:00,0,42,-42,No Signal,11985.6435546875
2022-06-24 17:30:00+00:00,0,41,-41,No Signal,11995.4423828125
2022-06-24 18:30:00+00:00,0,56,-56,No Signal,12019.0693359375
2022-06-24 19:30:00+00:00,0,65,-65,No Signal,12112.1591796875
2022-06-27 13:30:00+00:00,1,38,-37,No Signal,12012.01171875
2022-06-27 14:30:00+00:00,0,45,-45,No Signal,12103.5908203125
2022-06-27 15:30:00+00:00,0,40,-40,No Signal,12023.93359375
2022-06-27 16:30:00+00:00,0,54,-54,No Signal,12040.45703125
2022-06-27 17:30:00+00:00,0,44,-44,No Signal,12011.634765625
2022-06-27 18:30:00+00:00,0,40,-40,No Signal,12012.73046875
2022-06-27 19:30:00+00:00,0,34,-34,No Signal,11982.4599609375
2022-06-28 13:30:00+00:00,0,11,-11,No Signal,11983.1669921875
2022-06-28 14:30:00+00:00,3,5,-2,No Signal,11832.40234375
2022-06-28 15:30:00+00:00,13,5,8,No Signal,11773.36328125
2022-06-28 16:30:00+00:00,18,4,14,Long,11740.4765625
2022-06-28 17:30:00+00:00,21,4,17,No Signal,11696.1259765625
2022-06-28 18:30:00+00:00,29,4,25,No Signal,11676.5927734375
2022-06-28 19:30:00+00:00,54,1,53,No Signal,11637.4931640625
2022-06-29 13:30:00+00:00,38,2,36,No Signal,11655.822265625
2022-06-29 14:30:00+00:00,63,2,61,No Signal,11639.3935546875
2022-06-29 15:30:00+00:00,61,0,61,No Signal,11576.8701171875
2022-06-29 16:30:00+00:00,58,0,58,No Signal,11617.7099609375
2022-06-29 17:30:00+00:00,48,1,47,No Signal,11671.140625
2022-06-29 18:30:00+00:00,49,2,47,No Signal,11683.55859375
2022-06-29 19:30:00+00:00,47,1,46,No Signal,11659.1875
2022-06-30 13:30:00+00:00,71,1,70,No Signal,11358.44921875
2022-06-30 14:30:00+00:00,22,1,21,No Signal,11548.890625
2022-06-30 15:30:00+00:00,5,2,3,No Signal,11619.3544921875
2022-06-30 16:30:00+00:00,5,2,3,No Signal,11580.1796875
2022-06-30 17:30:00+00:00,4,2,2,No Signal,11574.4453125
2022-06-30 18:30:00+00:00,5,6,-1,No Signal,11521.234375
2022-06-30 19:30:00+00:00,4,4,0,No Signal,11507.521484375
2022-07-01 13:30:00+00:00,11,6,5,No Signal,11420.9228515625
2022-07-01 14:30:00+00:00,9,8,1,No Signal,11453.1318359375
2022-07-01 15:30:00+00:00,6,7,-1,No Signal,11459.2763671875
2022-07-01 16:30:00+00:00,8,6,2,No Signal,11446.3291015625
2022-07-01 17:30:00+00:00,6,9,-3,No Signal,11516.48828125
2022-07-01 18:30:00+00:00,5,8,-3,No Signal,11545.638671875
2022-07-01 19:30:00+00:00,5,12,-7,No Signal,11582.1689453125
2022-07-05 13:30:00+00:00,3,28,-25,Short,11471.6708984375
2022-07-05 14:30:00+00:00,18,17,1,No Signal,11467.578125
2022-07-05 15:30:00+00:00,16,17,-1,No Signal,11604.4931640625
2022-07-05 16:30:00+00:00,14,23,-9,No Signal,11636.412109375
2022-07-05 17:30:00+00:00,9,26,-17,No Signal,11684.4189453125
2022-07-05 18:30:00+00:00,4,35,-31,No Signal,11763.470703125
2022-07-05 19:30:00+00:00,4,41,-37,No Signal,11780.9814453125
2022-07-06 13:30:00+00:00,1,39,-38,No Signal,11786.1240234375
2022-07-06 14:30:00+00:00,3,33,-30,No Signal,11764.607421875
2022-07-06 15:30:00+00:00,2,35,-33,No Signal,11778.1572265625
2022-07-06 16:30:00+00:00,1,39,-38,No Signal,11808.1689453125
2022-07-06 17:30:00+00:00,1,37,-36,No Signal,11843.4345703125
2022-07-06 18:30:00+00:00,1,41,-40,No Signal,11925.53515625
2022-07-06 19:30:00+00:00,0,26,-26,No Signal,11852.6767578125
2022-07-07 13:30:00+00:00,2,52,-50,No Signal,12004.13671875
2022-07-07 14:30:00+00:00,0,64,-64,No Signal,12009.439453125
2022-07-07 15:30:00+00:00,0,54,-54,No Signal,12062.5546875
2022-07-07 16:30:00+00:00,1,53,-52,No Signal,12057.529296875
2022-07-07 17:30:00+00:00,1,51,-50,No Signal,12114.099609375
2022-07-07 18:30:00+00:00,1,45,-44,No Signal,12113.40234375
2022-07-07 19:30:00+00:00,3,41,-38,No Signal,12104.1845703125
2022-07-08 13:30:00+00:00,0,40,-40,No Signal,12084.8837890625
2022-07-08 14:30:00+00:00,0,56,-56,No Signal,12174.0107421875
2022-07-08 15:30:00+00:00,0,23,-23,No Signal,12062.185546875
2022-07-08 16:30:00+00:00,1,24,-23,No Signal,12087.6298828125
2022-07-08 17:30:00+00:00,1,25,-24,No Signal,12135.9921875
2022-07-08 18:30:00+00:00,1,13,-12,No Signal,12124.3916015625
2022-07-08 19:30:00+00:00,1,24,-23,No Signal,12125.8369140625
2022-07-11 13:30:00+00:00,8,2,6,No Signal,11884.9501953125
2022-07-11 14:30:00+00:00,9,1,8,No Signal,11910.103515625
2022-07-11 15:30:00+00:00,15,1,14,Long,11900.611328125
2022-07-11 16:30:00+00:00,8,0,8,No Signal,11950.970703125
2022-07-11 17:30:00+00:00,16,0,16,No Signal,11918.701171875
2022-07-11 18:30:00+00:00,21,0,21,No Signal,11870.5361328125
2022-07-11 19:30:00+00:00,20,0,20,No Signal,11860.0859375
2022-07-12 13:30:00+00:00,30,0,30,No Signal,11808.236328125
2022-07-12 14:30:00+00:00,32,2,30,No Signal,11890.0400390625
2022-07-12 15:30:00+00:00,20,2,18,No Signal,11875.8125
2022-07-12 16:30:00+00:00,29,1,28,No Signal,11851.1064453125
2022-07-12 17:30:00+00:00,34,1,33,No Signal,11847.7666015625
2022-07-12 18:30:00+00:00,45,0,45,No Signal,11722.2333984375
2022-07-12 19:30:00+00:00,42,0,42,No Signal,11746.9609375
2022-07-13 13:30:00+00:00,34,2,32,No Signal,11634.8115234375
2022-07-13 14:30:00+00:00,27,2,25,No Signal,11717.1015625
2022-07-13 15:30:00+00:00,19,3,16,No Signal,11744.509765625
2022-07-13 16:30:00+00:00,22,2,20,No Signal,11783.591796875
2022-07-13 17:30:00+00:00,20,3,17,No Signal,11775.205078125
2022-07-13 18:30:00+00:00,18,4,14,No Signal,11761.82421875
2022-07-13 19:30:00+00:00,21,2,19,No Signal,11726.796875
2022-07-14 13:30:00+00:00,35,1,34,No Signal,11528.6630859375
2022-07-14 14:30:00+00:00,32,0,32,No Signal,11624.490234375
2022-07-14 15:30:00+00:00,29,2,27,No Signal,11626.126953125
2022-07-14 16:30:00+00:00,20,2,18,No Signal,11679.8955078125
2022-07-14 17:30:00+00:00,19,3,16,No Signal,11771.205078125
2022-07-14 18:30:00+00:00,7,12,-5,No Signal,11791.814453125
2022-07-14 19:30:00+00:00,11,10,1,No Signal,11765.3388671875
2022-07-15 13:30:00+00:00,4,24,-20,Short,11940.8857421875
2022-07-15 14:30:00+00:00,11,19,-8,No Signal,11948.8369140625
2022-07-15 15:30:00+00:00,9,15,-6,No Signal,11925.658203125
2022-07-15 16:30:00+00:00,8,13,-5,No Signal,11947.3193359375
2022-07-15 17:30:00+00:00,8,12,-4,No Signal,11947.4990234375
2022-07-15 18:30:00+00:00,4,17,-13,No Signal,11949.0380859375
2022-07-15 19:30:00+00:00,3,22,-19,No Signal,11984.146484375
2022-07-18 13:30:00+00:00,0,71,-71,No Signal,12097.4697265625
2022-07-18 14:30:00+00:00,0,62,-62,No Signal,12112.8525390625
2022-07-18 15:30:00+00:00,0,69,-69,No Signal,12136.912109375
2022-07-18 16:30:00+00:00,0,65,-65,No Signal,12096.24609375
2022-07-18 17:30:00+00:00,2,16,-14,No Signal,11953.73828125
2022-07-18 18:30:00+00:00,6,8,-2,No Signal,11896.21875
2022-07-18 19:30:00+00:00,4,7,-3,No Signal,11873.6513671875
2022-07-19 13:30:00+00:00,2,20,-18,No Signal,12056.57421875
2022-07-19 14:30:00+00:00,0,28,-28,No Signal,12138.0302734375
2022-07-19 15:30:00+00:00,0,28,-28,No Signal,12156.19140625
2022-07-19 16:30:00+00:00,1,28,-27,No Signal,12171.0302734375
2022-07-19 17:30:00+00:00,0,29,-29,No Signal,12204.658203125
2022-07-19 18:30:00+00:00,0,33,-33,No Signal,12230.9833984375
2022-07-19 19:30:00+00:00,1,29,-28,No Signal,12245.1103515625
2022-07-20 13:30:00+00:00,3,38,-35,No Signal,12364.8232421875
2022-07-20 14:30:00+00:00,1,42,-41,No Signal,12441.5634765625
2022-07-20 15:30:00+00:00,4,43,-39,No Signal,12458.73828125
2022-07-20 16:30:00+00:00,3,36,-33,No Signal,12384.59375
2022-07-20 17:30:00+00:00,0,64,-64,No Signal,12418.736328125
2022-07-20 18:30:00+00:00,0,73,-73,No Signal,12468.4140625
2022-07-20 19:30:00+00:00,1,69,-68,No Signal,12438.5263671875
2022-07-21 13:30:00+00:00,4,53,-49,No Signal,12372.8671875
2022-07-21 14:30:00+00:00,3,54,-51,No Signal,12480.3369140625
2022-07-21 15:30:00+00:00,1,55,-54,No Signal,12578.7578125
2022-07-21 16:30:00+00:00,2,53,-51,No Signal,12555.986328125
2022-07-21 17:30:00+00:00,4,52,-48,No Signal,12585.123046875
2022-07-21 18:30:00+00:00,4,48,-44,No Signal,12585.712890625
2022-07-21 19:30:00+00:00,4,51,-47,No Signal,12619.0986328125
2022-07-22 13:30:00+00:00,2,26,-24,No Signal,12554.2763671875
2022-07-22 14:30:00+00:00,5,8,-3,No Signal,12464.1083984375
2022-07-22 15:30:00+00:00,9,6,3,No Signal,12402.080078125
2022-07-22 16:30:00+00:00,8,8,0,No Signal,12368.0205078125
2022-07-22 17:30:00+00:00,9,2,7,No Signal,12341.5126953125
2022-07-22 18:30:00+00:00,10,3,7,No Signal,12400.0537109375
2022-07-22 19:30:00+00:00,10,5,5,No Signal,12398.3330078125
2022-07-25 13:30:00+00:00,11,8,3,No Signal,12306.189453125
2022-07-25 14:30:00+00:00,17,7,10,Long,12330.99609375
2022-07-25 15:30:00+00:00,28,6,22,No Signal,12330.79296875
2022-07-25 16:30:00+00:00,25,8,17,No Signal,12335.33203125
2022-07-25 17:30:00+00:00,36,5,31,No Signal,12286.7353515625
2022-07-25 18:30:00+00:00,38,4,34,No Signal,12257.8154296875
2022-07-25 19:30:00+00:00,31,5,26,No Signal,12326.19921875
2022-07-26 13:30:00+00:00,47,4,43,No Signal,12159.939453125
2022-07-26 14:30:00+00:00,42,5,37,No Signal,12123.81640625
2022-07-26 15:30:00+00:00,32,6,26,No Signal,12108.8984375
2022-07-26 16:30:00+00:00,27,9,18,No Signal,12129.1484375
2022-07-26 17:30:00+00:00,28,8,20,No Signal,12070.17578125
2022-07-26 18:30:00+00:00,40,9,31,No Signal,12071.578125
2022-07-26 19:30:00+00:00,41,7,34,No Signal,12083.068359375
2022-07-27 13:30:00+00:00,5,12,-7,No Signal,12384.2275390625
2022-07-27 14:30:00+00:00,5,6,-1,No Signal,12398.4912109375
2022-07-27 15:30:00+00:00,4,6,-2,No Signal,12439.3603515625
2022-07-27 16:30:00+00:00,5,6,-1,No Signal,12414.4853515625
2022-07-27 17:30:00+00:00,5,12,-7,No Signal,12433.2978515625
2022-07-27 18:30:00+00:00,0,37,-37,Short,12651.2119140625
2022-07-27 19:30:00+00:00,2,14,-12,No Signal,12594.8740234375
2022-07-28 13:30:00+00:00,2,25,-23,No Signal,12453.62109375
2022-07-28 14:30:00+00:00,1,51,-50,No Signal,12640.9833984375
2022-07-28 15:30:00+00:00,3,47,-44,No Signal,12647.5
2022-07-28 16:30:00+00:00,4,50,-46,No Signal,12664.9443359375
2022-07-28 17:30:00+00:00,1,62,-61,No Signal,12686.4599609375
2022-07-28 18:30:00+00:00,1,68,-67,No Signal,12726.9736328125
2022-07-28 19:30:00+00:00,1,68,-67,No Signal,12713.96875
2022-07-29 13:30:00+00:00,2,55,-53,No Signal,12898.3896484375
2022-07-29 14:30:00+00:00,5,38,-33,No Signal,12780.16015625
2022-07-29 15:30:00+00:00,4,38,-34,No Signal,12838.9443359375
2022-07-29 16:30:00+00:00,4,49,-45,No Signal,12871.3583984375
2022-07-29 17:30:00+00:00,3,49,-46,No Signal,12929.6630859375
2022-07-29 18:30:00+00:00,4,36,-32,No Signal,12969.3349609375
2022-07-29 19:30:00+00:00,6,45,-39,No Signal,12945.3212890625
2022-08-01 13:30:00+00:00,0,48,-48,No Signal,12960.333984375
2022-08-01 14:30:00+00:00,5,36,-31,No Signal,13051.017578125
2022-08-01 15:30:00+00:00,3,30,-27,No Signal,13013.28515625
2022-08-01 16:30:00+00:00,3,17,-14,No Signal,12920.0185546875
2022-08-01 17:30:00+00:00,8,14,-6,No Signal,12929.48046875
2022-08-01 18:30:00+00:00,6,12,-6,No Signal,12926.91015625
2022-08-01 19:30:00+00:00,3,15,-12,No Signal,12941.9091796875
2022-08-02 13:30:00+00:00,3,4,-1,No Signal,12880.9873046875
2022-08-02 14:30:00+00:00,0,20,-20,No Signal,12946.8984375
2022-08-02 15:30:00+00:00,0,27,-27,No Signal,13053.6220703125
2022-08-02 16:30:00+00:00,0,12,-12,No Signal,12973.41015625
2022-08-02 17:30:00+00:00,0,13,-13,No Signal,12959.59765625
2022-08-02 18:30:00+00:00,0,10,-10,No Signal,12940.234375
2022-08-02 19:30:00+00:00,0,4,-4,No Signal,12901.0947265625
2022-08-03 13:30:00+00:00,4,18,-14,No Signal,13109.3818359375
2022-08-03 14:30:00+00:00,2,13,-11,No Signal,13161.1396484375
2022-08-03 15:30:00+00:00,1,20,-19,No Signal,13189.673828125
2022-08-03 16:30:00+00:00,1,30,-29,No Signal,13247.9208984375
2022-08-03 17:30:00+00:00,1,37,-36,No Signal,13262.4248046875
2022-08-03 18:30:00+00:00,2,35,-33,No Signal,13252.4638671875
2022-08-03 19:30:00+00:00,2,28,-26,No Signal,13252.77734375
2022-08-04 13:30:00+00:00,2,39,-37,No Signal,13226.9638671875
2022-08-04 14:30:00+00:00,5,25,-20,No Signal,13203.26171875
2022-08-04 15:30:00+00:00,3,24,-21,No Signal,13291.1015625
2022-08-04 16:30:00+00:00,2,30,-28,No Signal,13283.35546875
2022-08-04 17:30:00+00:00,3,38,-35,No Signal,13283.23046875
2022-08-04 18:30:00+00:00,4,44,-40,No Signal,13312.90234375
2022-08-04 19:30:00+00:00,1,50,-49,No Signal,13310.751953125
2022-08-05 13:30:00+00:00,6,30,-24,No Signal,13251.353515625
2022-08-05 14:30:00+00:00,14,3,11,Long,13074.31640625
2022-08-05 15:30:00+00:00,12,7,5,No Signal,13146.7158203125
2022-08-05 16:30:00+00:00,11,5,6,No Signal,13194.2333984375
2022-08-05 17:30:00+00:00,16,6,10,No Signal,13137.8681640625
2022-08-05 18:30:00+00:00,10,6,4,No Signal,13168.7890625
2022-08-05 19:30:00+00:00,9,9,0,No Signal,13206.7197265625
2022-08-08 13:30:00+00:00,5,18,-13,Short,13334.4482421875
2022-08-08 14:30:00+00:00,6,18,-12,No Signal,13262.630859375
2022-08-08 15:30:00+00:00,13,5,8,No Signal,13152.2294921875
2022-08-08 16:30:00+00:00,9,5,4,No Signal,13171.80859375
2022-08-08 17:30:00+00:00,11,3,8,No Signal,13137.6005859375
2022-08-08 18:30:00+00:00,10,4,6,No Signal,13142.5478515625
2022-08-08 19:30:00+00:00,9,3,6,No Signal,13160.2431640625
2022-08-09 13:30:00+00:00,20,7,13,Long,13001.1796875
2022-08-09 14:30:00+00:00,6,12,-6,No Signal,13026.208984375
2022-08-09 15:30:00+00:00,23,6,17,No Signal,12947.7265625
2022-08-09 16:30:00+00:00,24,3,21,No Signal,12986.3935546875
2022-08-09 17:30:00+00:00,22,1,21,No Signal,12974.90625
2022-08-09 18:30:00+00:00,19,3,16,No Signal,13025.55078125
2022-08-09 19:30:00+00:00,27,1,26,No Signal,13008.9482421875
2022-08-10 13:30:00+00:00,10,0,10,No Signal,13261.798828125
2022-08-10 14:30:00+00:00,4,1,3,No Signal,13332.576171875
2022-08-10 15:30:00+00:00,2,11,-9,No Signal,13316.0673828125
2022-08-10 16:30:00+00:00,2,11,-9,No Signal,13329.4765625
2022-08-10 17:30:00+00:00,1,12,-11,Short,13340.7666015625
2022-08-10 18:30:00+00:00,2,15,-13,No Signal,13358.2041015625
2022-08-10 19:30:00+00:00,2,18,-16,No Signal,13373.5439453125
2022-08-11 13:30:00+00:00,0,61,-61,No Signal,13505.8935546875
2022-08-11 14:30:00+00:00,0,35,-35,No Signal,13397.134765625
2022-08-11 15:30:00+00:00,1,43,-42,No Signal,13385.3955078125
2022-08-11 16:30:00+00:00,2,47,-45,No Signal,13397.6943359375
2022-08-11 17:30:00+00:00,1,34,-33,No Signal,13338.9267578125
2022-08-11 18:30:00+00:00,1,17,-16,No Signal,13300.4130859375
2022-08-11 19:30:00+00:00,2,23,-21,No Signal,13292.0888671875
2022-08-12 13:30:00+00:00,3,13,-10,No Signal,13412.5263671875
2022-08-12 14:30:00+00:00,3,9,-6,No Signal,13449.099609375
2022-08-12 15:30:00+00:00,2,14,-12,No Signal,13475.408203125
2022-08-12 16:30:00+00:00,1,13,-12,No Signal,13481.3291015625
2022-08-12 17:30:00+00:00,0,15,-15,No Signal,13498.404296875
2022-08-12 18:30:00+00:00,1,16,-15,No Signal,13542.306640625
2022-08-12 19:30:00+00:00,2,14,-12,No Signal,13563.021484375
2022-08-15 13:30:00+00:00,9,9,0,No Signal,13548.68359375
2022-08-15 14:30:00+00:00,2,22,-20,No Signal,13570.9111328125
2022-08-15 15:30:00+00:00,2,34,-32,No Signal,13635.40234375
2022-08-15 16:30:00+00:00,1,32,-31,No Signal,13648.4267578125
2022-08-15 17:30:00+00:00,1,43,-42,No Signal,13634.716796875
2022-08-15 18:30:00+00:00,1,63,-62,No Signal,13682.380859375
2022-08-15 19:30:00+00:00,0,65,-65,No Signal,13662.611328125
2022-08-16 13:30:00+00:00,5,30,-25,No Signal,13550.232421875
2022-08-16 14:30:00+00:00,2,28,-26,No Signal,13612.1181640625
2022-08-16 15:30:00+00:00,1,26,-25,No Signal,13635.7998046875
2022-08-16 16:30:00+00:00,1,29,-28,No Signal,13649.908203125
2022-08-16 17:30:00+00:00,2,30,-28,No Signal,13692.0576171875
2022-08-16 18:30:00+00:00,1,17,-16,No Signal,13625.7666015625
2022-08-16 19:30:00+00:00,2,16,-14,No Signal,13635.2802734375
2022-08-17 13:30:00+00:00,10,5,5,No Signal,13469.015625
2022-08-17 14:30:00+00:00,19,6,13,Long,13440.4384765625
2022-08-17 15:30:00+00:00,32,2,30,No Signal,13444.189453125
2022-08-17 16:30:00+00:00,26,1,25,No Signal,13476.0869140625
2022-08-17 17:30:00+00:00,12,5,7,No Signal,13553.9404296875
2022-08-17 18:30:00+00:00,25,2,23,No Signal,13497.0576171875
2022-08-17 19:30:00+00:00,24,2,22,No Signal,13467.560546875
2022-08-18 13:30:00+00:00,15,2,13,No Signal,13451.5634765625
2022-08-18 14:30:00+00:00,10,2,8,No Signal,13531.462890625
2022-08-18 15:30:00+00:00,19,2,17,No Signal,13495.29296875
2022-08-18 16:30:00+00:00,15,2,13,No Signal,13523.248046875
2022-08-18 17:30:00+00:00,28,2,26,No Signal,13515.4326171875
2022-08-18 18:30:00+00:00,17,6,11,No Signal,13541.236328125
2022-08-18 19:30:00+00:00,20,4,16,No Signal,13506.6806640625
2022-08-19 13:30:00+00:00,25,2,23,No Signal,13276.0498046875
2022-08-19 14:30:00+00:00,23,2,21,No Signal,13248.0517578125
2022-08-19 15:30:00+00:00,25,2,23,No Signal,13252.08203125
2022-08-19 16:30:00+00:00,25,2,23,No Signal,13244.4921875
2022-08-19 17:30:00+00:00,48,1,47,No Signal,13240.60546875
2022-08-19 18:30:00+00:00,32,1,31,No Signal,13250.396484375
2022-08-19 19:30:00+00:00,33,2,31,No Signal,13243.0888671875
2022-08-22 13:30:00+00:00,68,3,65,No Signal,12963.0087890625
2022-08-22 14:30:00+00:00,76,0,76,No Signal,12941.2333984375
2022-08-22 15:30:00+00:00,72,2,70,No Signal,12961.806640625
2022-08-22 16:30:00+00:00,76,2,74,No Signal,12928.02734375
2022-08-22 17:30:00+00:00,81,1,80,No Signal,12904.3916015625
2022-08-22 18:30:00+00:00,81,0,81,No Signal,12889.263671875
2022-08-22 19:30:00+00:00,80,1,79,No Signal,12892.5078125
2022-08-23 13:30:00+00:00,58,5,53,No Signal,12939.9111328125
2022-08-23 14:30:00+00:00,56,5,51,No Signal,12896.0556640625
2022-08-23 15:30:00+00:00,62,6,56,No Signal,12870.1201171875
2022-08-23 16:30:00+00:00,54,5,49,No Signal,12933.5615234375
2022-08-23 17:30:00+00:00,54,4,50,No Signal,12929.97265625
2022-08-23 18:30:00+00:00,58,5,53,No Signal,12911.5908203125
2022-08-23 19:30:00+00:00,60,5,55,No Signal,12878.0625
2022-08-24 13:30:00+00:00,19,11,8,No Signal,12922.1044921875
2022-08-24 14:30:00+00:00,13,13,0,No Signal,12972.275390625
2022-08-24 15:30:00+00:00,11,12,-1,No Signal,12968.96484375
2022-08-24 16:30:00+00:00,12,7,5,No Signal,12900.7451171875
2022-08-24 17:30:00+00:00,6,9,-3,No Signal,12928.318359375
2022-08-24 18:30:00+00:00,3,9,-6,No Signal,12936.9619140625
2022-08-24 19:30:00+00:00,5,9,-4,No Signal,12913.8916015625
2022-08-25 13:30:00+00:00,2,19,-17,Short,13080.318359375
2022-08-25 14:30:00+00:00,2,12,-10,No Signal,13012.591796875
2022-08-25 15:30:00+00:00,2,17,-15,No Signal,13022.505859375
2022-08-25 16:30:00+00:00,2,17,-15,No Signal,13042.171875
2022-08-25 17:30:00+00:00,2,22,-20,No Signal,13071.033203125
2022-08-25 18:30:00+00:00,2,26,-24,No Signal,13074.7578125
2022-08-25 19:30:00+00:00,0,48,-48,No Signal,13145.59375
2022-08-26 13:30:00+00:00,2,6,-4,No Signal,12974.42578125
2022-08-26 14:30:00+00:00,7,5,2,No Signal,12814.7724609375
2022-08-26 15:30:00+00:00,6,5,1,No Signal,12767.9697265625
2022-08-26 16:30:00+00:00,2,4,-2,No Signal,12772.470703125
2022-08-26 17:30:00+00:00,9,3,6,No Signal,12712.0419921875
2022-08-26 18:30:00+00:00,14,3,11,Long,12673.1435546875
2022-08-26 19:30:00+00:00,20,2,18,No Signal,12606.369140625
2022-08-29 13:30:00+00:00,67,1,66,No Signal,12559.5009765625
2022-08-29 14:30:00+00:00,67,1,66,No Signal,12457.2587890625
2022-08-29 15:30:00+00:00,61,2,59,No Signal,12520.9404296875
2022-08-29 16:30:00+00:00,57,0,57,No Signal,12544.0576171875
2022-08-29 17:30:00+00:00,68,1,67,No Signal,12528.7900390625
2022-08-29 18:30:00+00:00,68,0,68,No Signal,12542.224609375
2022-08-29 19:30:00+00:00,78,0,78,No Signal,12481.564453125
2022-08-30 13:30:00+00:00,77,0,77,No Signal,12397.1728515625
2022-08-30 14:30:00+00:00,69,1,68,No Signal,12335.9482421875
2022-08-30 15:30:00+00:00,68,1,67,No Signal,12335.935546875
2022-08-30 16:30:00+00:00,76,0,76,No Signal,12270.201171875
2022-08-30 17:30:00+00:00,69,2,67,No Signal,12279.8125
2022-08-30 18:30:00+00:00,51,1,50,No Signal,12343.365234375
2022-08-30 19:30:00+00:00,35,1,34,No Signal,12343.5595703125
2022-08-31 13:30:00+00:00,27,2,25,No Signal,12373.771484375
2022-08-31 14:30:00+00:00,26,1,25,No Signal,12322.3076171875
2022-08-31 15:30:00+00:00,29,3,26,No Signal,12355.421875
2022-08-31 16:30:00+00:00,43,0,43,No Signal,12311.787109375
2022-08-31 17:30:00+00:00,34,0,34,No Signal,12318.0634765625
2022-08-31 18:30:00+00:00,28,3,25,No Signal,12326.611328125
2022-08-31 19:30:00+00:00,25,5,20,No Signal,12271.3759765625
2022-09-01 13:30:00+00:00,34,3,31,No Signal,12155.5224609375
2022-09-01 14:30:00+00:00,35,2,33,No Signal,12025.0595703125
2022-09-01 15:30:00+00:00,29,4,25,No Signal,12058.6103515625
2022-09-01 16:30:00+00:00,15,4,11,No Signal,12109.53125
2022-09-01 17:30:00+00:00,11,3,8,No Signal,12164.9228515625
2022-09-01 18:30:00+00:00,12,4,8,No Signal,12187.4228515625
2022-09-01 19:30:00+00:00,8,7,1,No Signal,12282.4052734375
2022-09-02 13:30:00+00:00,5,11,-6,No Signal,12395.7578125
2022-09-02 14:30:00+00:00,3,12,-9,No Signal,12408.294921875
2022-09-02 15:30:00+00:00,4,5,-1,No Signal,12305.3603515625
2022-09-02 16:30:00+00:00,8,2,6,No Signal,12133.044921875
2022-09-02 17:30:00+00:00,7,3,4,No Signal,12135.46875
2022-09-02 18:30:00+00:00,11,3,8,No Signal,12103.6640625
2022-09-02 19:30:00+00:00,9,2,7,No Signal,12103.61328125
2022-09-06 13:30:00+00:00,9,2,7,No Signal,11994.705078125
2022-09-06 14:30:00+00:00,2,6,-4,No Signal,12065.73828125
2022-09-06 15:30:00+00:00,5,5,0,No Signal,12038.1806640625
2022-09-06 16:30:00+00:00,9,3,6,No Signal,11978.287109375
2022-09-06 17:30:00+00:00,6,5,1,No Signal,12034.203125
2022-09-06 18:30:00+00:00,10,4,6,No Signal,12029.70703125
2022-09-06 19:30:00+00:00,21,4,17,No Signal,12012.099609375
2022-09-07 13:30:00+00:00,30,2,28,No Signal,12065.8544921875
2022-09-07 14:30:00+00:00,29,3,26,No Signal,12121.2373046875
2022-09-07 15:30:00+00:00,17,7,10,No Signal,12111.267578125
2022-09-07 16:30:00+00:00,4,17,-13,Short,12145.87109375
2022-09-07 17:30:00+00:00,3,19,-16,No Signal,12238.734375
2022-09-07 18:30:00+00:00,0,31,-31,No Signal,12295.5634765625
2022-09-07 19:30:00+00:00,1,27,-26,No Signal,12258.0732421875
2022-09-08 13:30:00+00:00,3,39,-36,No Signal,12248.74609375
2022-09-08 14:30:00+00:00,0,44,-44,No Signal,12356.009765625
2022-09-08 15:30:00+00:00,1,19,-18,No Signal,12173.5361328125
2022-09-08 16:30:00+00:00,0,46,-46,No Signal,12272.0849609375
2022-09-08 17:30:00+00:00,0,33,-33,No Signal,12261.3447265625
2022-09-08 18:30:00+00:00,0,35,-35,No Signal,12275.0263671875
2022-09-08 19:30:00+00:00,0,42,-42,No Signal,12321.021484375
2022-09-09 13:30:00+00:00,0,50,-50,No Signal,12521.158203125
2022-09-09 14:30:00+00:00,0,50,-50,No Signal,12555.4453125
2022-09-09 15:30:00+00:00,0,44,-44,No Signal,12526.630859375
2022-09-09 16:30:00+00:00,0,47,-47,No Signal,12583.234375
2022-09-09 17:30:00+00:00,0,39,-39,No Signal,12594.0283203125
2022-09-09 18:30:00+00:00,0,34,-34,No Signal,12592.048828125
2022-09-09 19:30:00+00:00,0,39,-39,No Signal,12587.9814453125
2022-09-12 13:30:00+00:00,0,58,-58,No Signal,12737.45703125
2022-09-12 14:30:00+00:00,1,35,-34,No Signal,12728.6552734375
2022-09-12 15:30:00+00:00,0,67,-67,No Signal,12683.81640625
2022-09-12 16:30:00+00:00,1,60,-59,No Signal,12729.859375
2022-09-12 17:30:00+00:00,2,51,-49,No Signal,12691.453125
2022-09-12 18:30:00+00:00,3,56,-53,No Signal,12714.4619140625
2022-09-12 19:30:00+00:00,1,55,-54,No Signal,12739.4765625
2022-09-13 13:30:00+00:00,23,2,21,Long,12295.5
2022-09-13 14:30:00+00:00,36,0,36,No Signal,12193.08203125
2022-09-13 15:30:00+00:00,33,2,31,No Signal,12206.1064453125
2022-09-13 16:30:00+00:00,29,1,28,No Signal,12252.1669921875
2022-09-13 17:30:00+00:00,45,2,43,No Signal,12174.951171875
2022-09-13 18:30:00+00:00,57,1,56,No Signal,12075.6103515625
2022-09-13 19:30:00+00:00,55,0,55,No Signal,12034.8193359375
2022-09-14 13:30:00+00:00,80,0,80,No Signal,12026.9580078125
2022-09-14 14:30:00+00:00,64,0,64,No Signal,12117.65234375
2022-09-14 15:30:00+00:00,60,1,59,No Signal,12123.5322265625
2022-09-14 16:30:00+00:00,60,1,59,No Signal,12137.255859375
2022-09-14 17:30:00+00:00,61,0,61,No Signal,12072.2255859375
2022-09-14 18:30:00+00:00,70,0,70,No Signal,12044.1591796875
2022-09-14 19:30:00+00:00,62,0,62,No Signal,12139.12109375
2022-09-15 13:30:00+00:00,31,2,29,No Signal,12038.7841796875
2022-09-15 14:30:00+00:00,26,4,22,No Signal,11972.5126953125
2022-09-15 15:30:00+00:00,30,3,27,No Signal,11939.59375
2022-09-15 16:30:00+00:00,16,2,14,No Signal,12058.36328125
2022-09-15 17:30:00+00:00,15,1,14,No Signal,11982.0810546875
2022-09-15 18:30:00+00:00,13,0,13,No Signal,11874.259765625
2022-09-15 19:30:00+00:00,5,2,3,No Signal,11929.357421875
2022-09-16 13:30:00+00:00,14,0,14,No Signal,11773.224609375
2022-09-16 14:30:00+00:00,25,0,25,No Signal,11748.2275390625
2022-09-16 15:30:00+00:00,34,0,34,No Signal,11718.41015625
2022-09-16 16:30:00+00:00,39,0,39,No Signal,11746.287109375
2022-09-16 17:30:00+00:00,16,1,15,No Signal,11799.5439453125
2022-09-16 18:30:00+00:00,13,2,11,No Signal,11824.1689453125
2022-09-16 19:30:00+00:00,21,2,19,No Signal,11857.9765625
2022-09-19 13:30:00+00:00,23,0,23,No Signal,11845.06640625
2022-09-19 14:30:00+00:00,13,0,13,No Signal,11838.015625
2022-09-19 15:30:00+00:00,12,0,12,No Signal,11812.1689453125
2022-09-19 16:30:00+00:00,24,0,24,No Signal,11870.73828125
2022-09-19 17:30:00+00:00,17,1,16,No Signal,11847.26171875
2022-09-19 18:30:00+00:00,1,11,-10,Short,11938.546875
2022-09-19 19:30:00+00:00,5,10,-5,No Signal,11954.7763671875
2022-09-20 13:30:00+00:00,2,10,-8,No Signal,11860.4775390625
2022-09-20 14:30:00+00:00,2,14,-12,No Signal,11904.3291015625
2022-09-20 15:30:00+00:00,3,19,-16,No Signal,11895.0986328125
2022-09-20 16:30:00+00:00,4,7,-3,No Signal,11815.2666015625
2022-09-20 17:30:00+00:00,5,4,1,No Signal,11814.79296875
2022-09-20 18:30:00+00:00,5,5,0,No Signal,11860.640625
2022-09-20 19:30:00+00:00,8,2,6,No Signal,11851.94921875
2022-09-21 13:30:00+00:00,3,9,-6,No Signal,11927.822265625
2022-09-21 14:30:00+00:00,1,6,-5,No Signal,11895.4921875
2022-09-21 15:30:00+00:00,1,9,-8,No Signal,11921.8818359375
2022-09-21 16:30:00+00:00,4,7,-3,No Signal,11911.2626953125
2022-09-21 17:30:00+00:00,8,1,7,No Signal,11783.814453125
2022-09-21 18:30:00+00:00,21,0,21,Long,11789.18359375
2022-09-21 19:30:00+00:00,39,0,39,No Signal,11636.6083984375
2022-09-22 13:30:00+00:00,45,0,45,No Signal,11534.603515625
2022-09-22 14:30:00+00:00,54,0,54,No Signal,11477.701171875
2022-09-22 15:30:00+00:00,47,0,47,No Signal,11513.3642578125
2022-09-22 16:30:00+00:00,42,1,41,No Signal,11504.046875
2022-09-22 17:30:00+00:00,46,0,46,No Signal,11476.7177734375
2022-09-22 18:30:00+00:00,38,0,38,No Signal,11560.138671875
2022-09-22 19:30:00+00:00,44,0,44,No Signal,11498.7626953125
2022-09-23 13:30:00+00:00,82,0,82,No Signal,11337.595703125
2022-09-23 14:30:00+00:00,83,0,83,No Signal,11315.80078125
2022-09-23 15:30:00+00:00,87,0,87,No Signal,11242.9599609375
2022-09-23 16:30:00+00:00,86,0,86,No Signal,11258.427734375
2022-09-23 17:30:00+00:00,82,0,82,No Signal,11220.525390625
2022-09-23 18:30:00+00:00,71,0,71,No Signal,11258.9833984375
2022-09-23 19:30:00+00:00,41,1,40,No Signal,11317.044921875
2022-09-26 13:30:00+00:00,6,1,5,No Signal,11459.6826171875
2022-09-26 14:30:00+00:00,9,0,9,No Signal,11317.1181640625
2022-09-26 15:30:00+00:00,23,0,23,No Signal,11269.666015625
2022-09-26 16:30:00+00:00,18,0,18,No Signal,11261.22265625
2022-09-26 17:30:00+00:00,19,0,19,No Signal,11265.9638671875
2022-09-26 18:30:00+00:00,22,0,22,No Signal,11313.640625
2022-09-26 19:30:00+00:00,22,1,21,No Signal,11249.8212890625
2022-09-27 13:30:00+00:00,6,3,3,No Signal,11375.2783203125
2022-09-27 14:30:00+00:00,6,3,3,No Signal,11318.6962890625
2022-09-27 15:30:00+00:00,4,0,4,No Signal,11217.3173828125
2022-09-27 16:30:00+00:00,7,0,7,No Signal,11216.6103515625
2022-09-27 17:30:00+00:00,6,1,5,No Signal,11216.9560546875
2022-09-27 18:30:00+00:00,8,1,7,No Signal,11247.314453125
2022-09-27 19:30:00+00:00,11,0,11,No Signal,11273.9326171875
2022-09-28 13:30:00+00:00,8,1,7,No Signal,11336.4638671875
2022-09-28 14:30:00+00:00,4,6,-2,No Signal,11365.9453125
2022-09-28 15:30:00+00:00,1,27,-26,Short,11403.8642578125
2022-09-28 16:30:00+00:00,1,30,-29,No Signal,11433.080078125
2022-09-28 17:30:00+00:00,1,28,-27,No Signal,11433.046875
2022-09-28 18:30:00+00:00,1,30,-29,No Signal,11497.7119140625
2022-09-28 19:30:00+00:00,2,49,-47,No Signal,11488.5751953125
2022-09-29 13:30:00+00:00,12,3,9,No Signal,11144.1669921875
2022-09-29 14:30:00+00:00,10,4,6,No Signal,11159.8603515625
2022-09-29 15:30:00+00:00,7,13,-6,No Signal,11149.3818359375
2022-09-29 16:30:00+00:00,7,9,-2,No Signal,11119.7255859375
2022-09-29 17:30:00+00:00,11,5,6,No Signal,11077.5869140625
2022-09-29 18:30:00+00:00,11,5,6,No Signal,11103.505859375
2022-09-29 19:30:00+00:00,9,6,3,No Signal,11169.951171875
2022-09-30 13:30:00+00:00,8,2,6,No Signal,11200.35546875
2022-09-30 14:30:00+00:00,5,3,2,No Signal,11273.3740234375
2022-09-30 15:30:00+00:00,13,1,12,Long,11170.578125
2022-09-30 16:30:00+00:00,13,1,12,No Signal,11170.3203125
2022-09-30 17:30:00+00:00,19,0,19,No Signal,11105.3486328125
2022-09-30 18:30:00+00:00,41,1,40,No Signal,11068.560546875
2022-09-30 19:30:00+00:00,48,0,48,No Signal,10974.5458984375
2022-10-03 13:30:00+00:00,2,5,-3,No Signal,11147.8212890625
2022-10-03 14:30:00+00:00,3,4,-1,No Signal,11166.5517578125
2022-10-03 15:30:00+00:00,5,2,3,No Signal,11131.322265625
2022-10-03 16:30:00+00:00,3,6,-3,No Signal,11190.796875
2022-10-03 17:30:00+00:00,1,15,-14,Short,11264.6884765625
2022-10-03 18:30:00+00:00,1,13,-12,No Signal,11285.1474609375
2022-10-03 19:30:00+00:00,2,3,-1,No Signal,11228.6875
2022-10-04 13:30:00+00:00,0,32,-32,No Signal,11566.15234375
2022-10-04 14:30:00+00:00,0,26,-26,No Signal,11591.421875
2022-10-04 15:30:00+00:00,1,59,-58,No Signal,11581.24609375
2022-10-04 16:30:00+00:00,1,29,-28,No Signal,11502.138671875
2022-10-04 17:30:00+00:00,0,53,-53,No Signal,11524.849609375
2022-10-04 18:30:00+00:00,0,68,-68,No Signal,11550.490234375
2022-10-04 19:30:00+00:00,0,82,-82,No Signal,11581.60546875
2022-10-05 13:30:00+00:00,0,16,-16,No Signal,11333.0986328125
2022-10-05 14:30:00+00:00,1,17,-16,No Signal,11368.1875
2022-10-05 15:30:00+00:00,1,36,-35,No Signal,11454.27734375
2022-10-05 16:30:00+00:00,0,37,-37,No Signal,11537.9208984375
2022-10-05 17:30:00+00:00,1,28,-27,No Signal,11549.07421875
2022-10-05 18:30:00+00:00,1,33,-32,No Signal,11609.7177734375
2022-10-05 19:30:00+00:00,0,35,-35,No Signal,11565.357421875
2022-10-06 13:30:00+00:00,6,4,2,No Signal,11476.7275390625
2022-10-06 14:30:00+00:00,3,5,-2,No Signal,11589.099609375
2022-10-06 15:30:00+00:00,6,3,3,No Signal,11543.1376953125
2022-10-06 16:30:00+00:00,5,6,-1,No Signal,11572.2314453125
2022-10-06 17:30:00+00:00,6,2,4,No Signal,11530.01953125
2022-10-06 18:30:00+00:00,6,2,4,No Signal,11517.7412109375
2022-10-06 19:30:00+00:00,7,3,4,No Signal,11484.625
2022-10-07 13:30:00+00:00,6,1,5,No Signal,11190.6279296875
2022-10-07 14:30:00+00:00,10,1,9,No Signal,11155.33984375
2022-10-07 15:30:00+00:00,37,1,36,Long,11094.0341796875
2022-10-07 16:30:00+00:00,62,1,61,No Signal,11079.673828125
2022-10-07 17:30:00+00:00,66,1,65,No Signal,11043.9267578125
2022-10-07 18:30:00+00:00,77,1,76,No Signal,11016.4013671875
2022-10-07 19:30:00+00:00,72,1,71,No Signal,11041.29296875
2022-10-10 13:30:00+00:00,51,3,48,No Signal,10985.708984375
2022-10-10 14:30:00+00:00,72,1,71,No Signal,10913.2216796875
2022-10-10 15:30:00+00:00,75,1,74,No Signal,10865.568359375
2022-10-10 16:30:00+00:00,75,1,74,No Signal,10877.744140625
2022-10-10 17:30:00+00:00,65,0,65,No Signal,10944.767578125
2022-10-10 18:30:00+00:00,64,0,64,No Signal,10952.849609375
2022-10-10 19:30:00+00:00,63,0,63,No Signal,10924.9091796875
2022-10-11 13:30:00+00:00,63,1,62,No Signal,10778.52734375
2022-10-11 14:30:00+00:00,39,3,36,No Signal,10853.9267578125
2022-10-11 15:30:00+00:00,27,5,22,No Signal,10915.9287109375
2022-10-11 16:30:00+00:00,28,5,23,No Signal,10903.2958984375
2022-10-11 17:30:00+00:00,24,8,16,No Signal,10896.955078125
2022-10-11 18:30:00+00:00,30,6,24,No Signal,10757.9658203125
2022-10-11 19:30:00+00:00,27,3,24,No Signal,10793.587890625
2022-10-12 13:30:00+00:00,26,4,22,No Signal,10812.0830078125
2022-10-12 14:30:00+00:00,14,7,7,No Signal,10833.3720703125
2022-10-12 15:30:00+00:00,14,6,8,No Signal,10809.80078125
2022-10-12 16:30:00+00:00,12,4,8,No Signal,10820.984375
2022-10-12 17:30:00+00:00,18,6,12,No Signal,10854.7138671875
2022-10-12 18:30:00+00:00,21,3,18,No Signal,10809.1201171875
2022-10-12 19:30:00+00:00,23,2,21,No Signal,10784.5556640625
2022-10-13 13:30:00+00:00,27,0,27,No Signal,10568.2470703125
2022-10-13 14:30:00+00:00,5,2,3,No Signal,10871.853515625
2022-10-13 15:30:00+00:00,8,2,6,No Signal,10879.240234375
2022-10-13 16:30:00+00:00,0,2,-2,No Signal,11015.22265625
2022-10-13 17:30:00+00:00,2,1,1,No Signal,10958.5869140625
2022-10-13 18:30:00+00:00,0,12,-12,Short,11042.3427734375
2022-10-13 19:30:00+00:00,1,8,-7,No Signal,11030.8603515625
2022-10-14 13:30:00+00:00,1,3,-2,No Signal,10871.685546875
2022-10-14 14:30:00+00:00,1,3,-2,No Signal,10871.595703125
2022-10-14 15:30:00+00:00,1,2,-1,No Signal,10784.1103515625
2022-10-14 16:30:00+00:00,3,2,1,No Signal,10776.8076171875
2022-10-14 17:30:00+00:00,4,1,3,No Signal,10743.9609375
2022-10-14 18:30:00+00:00,4,1,3,No Signal,10741.732421875
2022-10-14 19:30:00+00:00,4,1,3,No Signal,10695.384765625
2022-10-17 13:30:00+00:00,0,32,-32,No Signal,11037.0751953125
2022-10-17 14:30:00+00:00,0,11,-11,No Signal,11036.9111328125
2022-10-17 15:30:00+00:00,1,6,-5,No Signal,11051.5234375
2022-10-17 16:30:00+00:00,5,2,3,No Signal,11054.181640625
2022-10-17 17:30:00+00:00,3,2,1,No Signal,11060.5166015625
2022-10-17 18:30:00+00:00,6,1,5,No Signal,11068.5537109375
2022-10-17 19:30:00+00:00,5,0,5,No Signal,11060.8798828125
2022-10-18 13:30:00+00:00,0,32,-32,No Signal,11208.9228515625
2022-10-18 14:30:00+00:00,0,4,-4,No Signal,11077.447265625
2022-10-18 15:30:00+00:00,0,35,-35,No Signal,11136.291015625
2022-10-18 16:30:00+00:00,0,40,-40,No Signal,11154.1103515625
2022-10-18 17:30:00+00:00,0,49,-49,No Signal,11186.6865234375
2022-10-18 18:30:00+00:00,0,35,-35,No Signal,11101.4501953125
2022-10-18 19:30:00+00:00,0,52,-52,No Signal,11151.0966796875
2022-10-19 13:30:00+00:00,7,7,0,No Signal,11223.77734375
2022-10-19 14:30:00+00:00,7,3,4,No Signal,11137.05078125
2022-10-19 15:30:00+00:00,11,4,7,No Signal,11104.380859375
2022-10-19 16:30:00+00:00,13,4,9,No Signal,11043.537109375
2022-10-19 17:30:00+00:00,9,3,6,No Signal,11094.607421875
2022-10-19 18:30:00+00:00,10,1,9,No Signal,11069.8603515625
2022-10-19 19:30:00+00:00,8,3,5,No Signal,11106.1552734375
2022-10-20 13:30:00+00:00,12,5,7,No Signal,11262.8310546875
2022-10-20 14:30:00+00:00,8,9,-1,No Signal,11218.4443359375
2022-10-20 15:30:00+00:00,14,3,11,Long,11146.3798828125
2022-10-20 16:30:00+00:00,25,3,22,No Signal,11103.9482421875
2022-10-20 17:30:00+00:00,35,1,34,No Signal,11014.1767578125
2022-10-20 18:30:00+00:00,26,3,23,No Signal,11039.490234375
2022-10-20 19:30:00+00:00,34,3,31,No Signal,11044.5439453125
2022-10-21 13:30:00+00:00,29,2,27,No Signal,11068.5380859375
2022-10-21 14:30:00+00:00,17,4,13,No Signal,11079.1640625
2022-10-21 15:30:00+00:00,5,7,-2,No Signal,11143.935546875
2022-10-21 16:30:00+00:00,1,12,-11,Short,11197.669921875
2022-10-21 17:30:00+00:00,1,11,-10,No Signal,11248.953125
2022-10-21 18:30:00+00:00,2,22,-20,No Signal,11317.4482421875
2022-10-21 19:30:00+00:00,2,18,-16,No Signal,11311.1357421875
2022-10-24 13:30:00+00:00,15,11,4,No Signal,11207.337890625
2022-10-24 14:30:00+00:00,6,21,-15,No Signal,11327.0029296875
2022-10-24 15:30:00+00:00,5,41,-36,No Signal,11384.2275390625
2022-10-24 16:30:00+00:00,5,38,-33,No Signal,11349.28125
2022-10-24 17:30:00+00:00,5,52,-47,No Signal,11386.7412109375
2022-10-24 18:30:00+00:00,3,57,-54,No Signal,11457.6884765625
2022-10-24 19:30:00+00:00,3,56,-53,No Signal,11429.2685546875
2022-10-25 13:30:00+00:00,0,70,-70,No Signal,11601.6806640625
2022-10-25 14:30:00+00:00,0,68,-68,No Signal,11629.2568359375
2022-10-25 15:30:00+00:00,0,66,-66,No Signal,11644.9658203125
2022-10-25 16:30:00+00:00,0,52,-52,No Signal,11598.58203125
2022-10-25 17:30:00+00:00,0,47,-47,No Signal,11639.568359375
2022-10-25 18:30:00+00:00,2,46,-44,No Signal,11668.6982421875
2022-10-25 19:30:00+00:00,1,51,-50,No Signal,11668.265625
2022-10-26 13:30:00+00:00,1,74,-73,No Signal,11532.609375
2022-10-26 14:30:00+00:00,1,70,-69,No Signal,11636.208984375
2022-10-26 15:30:00+00:00,2,57,-55,No Signal,11595.0458984375
2022-10-26 16:30:00+00:00,1,43,-42,No Signal,11444.0537109375
2022-10-26 17:30:00+00:00,1,35,-34,No Signal,11437.3232421875
2022-10-26 18:30:00+00:00,6,21,-15,No Signal,11421.2998046875
2022-10-26 19:30:00+00:00,5,21,-16,No Signal,11401.6123046875
2022-10-27 13:30:00+00:00,10,21,-11,No Signal,11382.7880859375
2022-10-27 14:30:00+00:00,11,11,0,No Signal,11293.7919921875
2022-10-27 15:30:00+00:00,15,10,5,No Signal,11212.423828125
2022-10-27 16:30:00+00:00,13,11,2,No Signal,11251.05859375
2022-10-27 17:30:00+00:00,15,11,4,No Signal,11210.5185546875
2022-10-27 18:30:00+00:00,14,9,5,No Signal,11225.904296875
2022-10-27 19:30:00+00:00,16,5,11,Long,11191.427734375
2022-10-28 13:30:00+00:00,17,8,9,No Signal,11339.560546875
2022-10-28 14:30:00+00:00,15,10,5,No Signal,11409.3330078125
2022-10-28 15:30:00+00:00,9,10,-1,No Signal,11467.1865234375
2022-10-28 16:30:00+00:00,7,17,-10,Short,11487.0576171875
2022-10-28 17:30:00+00:00,7,20,-13,No Signal,11499.943359375
2022-10-28 18:30:00+00:00,6,28,-22,No Signal,11544.02734375
2022-10-28 19:30:00+00:00,6,27,-21,No Signal,11544.443359375
2022-10-31 13:30:00+00:00,11,10,1,No Signal,11359.0966796875
2022-10-31 14:30:00+00:00,8,21,-13,No Signal,11420.5283203125
2022-10-31 15:30:00+00:00,5,30,-25,No Signal,11437.6826171875
2022-10-31 16:30:00+00:00,6,26,-20,No Signal,11449.7548828125
2022-10-31 17:30:00+00:00,6,28,-22,No Signal,11428.8095703125
2022-10-31 18:30:00+00:00,7,28,-21,No Signal,11411.578125
2022-10-31 19:30:00+00:00,6,34,-28,No Signal,11406.3759765625
2022-11-01 13:30:00+00:00,2,23,-21,No Signal,11394.0283203125
2022-11-01 14:30:00+00:00,4,9,-5,No Signal,11334.5283203125
2022-11-01 15:30:00+00:00,9,5,4,No Signal,11304.580078125
2022-11-01 16:30:00+00:00,13,2,11,Long,11312.7939453125
2022-11-01 17:30:00+00:00,14,4,10,No Signal,11317.4990234375
2022-11-01 18:30:00+00:00,15,4,11,No Signal,11295.576171875
2022-11-01 19:30:00+00:00,17,2,15,No Signal,11287.53125
2022-11-02 13:30:00+00:00,21,13,8,No Signal,11226.4423828125
2022-11-02 14:30:00+00:00,29,10,19,No Signal,11191.63671875
2022-11-02 15:30:00+00:00,32,10,22,No Signal,11163.4443359375
2022-11-02 16:30:00+00:00,31,9,22,No Signal,11177.2109375
2022-11-02 17:30:00+00:00,6,23,-17,Short,11391.78125
2022-11-02 18:30:00+00:00,26,1,25,Long,10984.6689453125
2022-11-02 19:30:00+00:00,32,1,31,No Signal,10903.478515625
2022-11-03 13:30:00+00:00,39,0,39,No Signal,10810.6337890625
2022-11-03 14:30:00+00:00,35,0,35,No Signal,10748.7138671875
2022-11-03 15:30:00+00:00,29,0,29,No Signal,10782.365234375
2022-11-03 16:30:00+00:00,32,0,32,No Signal,10770.5576171875
2022-11-03 17:30:00+00:00,33,0,33,No Signal,10774.748046875
2022-11-03 18:30:00+00:00,33,2,31,No Signal,10762.35546875
2022-11-03 19:30:00+00:00,33,0,33,No Signal,10691.4921875
2022-11-04 13:30:00+00:00,17,2,15,No Signal,10889.98046875
2022-11-04 14:30:00+00:00,19,2,17,No Signal,10777.1728515625
2022-11-04 15:30:00+00:00,24,2,22,No Signal,10746.5751953125
2022-11-04 16:30:00+00:00,26,2,24,No Signal,10666.228515625
2022-11-04 17:30:00+00:00,45,2,43,No Signal,10708.8037109375
2022-11-04 18:30:00+00:00,18,11,7,No Signal,10802.4130859375
2022-11-04 19:30:00+00:00,12,14,-2,No Signal,10856.3740234375
2022-11-07 14:30:00+00:00,14,21,-7,No Signal,10854.322265625
2022-11-07 15:30:00+00:00,11,29,-18,Short,10902.728515625
2022-11-07 16:30:00+00:00,13,18,-5,No Signal,10860.6826171875
2022-11-07 17:30:00+00:00,12,19,-7,No Signal,10885.9375
2022-11-07 18:30:00+00:00,9,27,-18,No Signal,10959.3623046875
2022-11-07 19:30:00+00:00,7,29,-22,No Signal,10988.0771484375
2022-11-07 20:30:00+00:00,7,35,-28,No Signal,10977.859375
2022-11-08 14:30:00+00:00,3,30,-27,No Signal,11052.53125
2022-11-08 15:30:00+00:00,1,50,-49,No Signal,11152.4052734375
2022-11-08 16:30:00+00:00,1,56,-55,No Signal,11159.3447265625
2022-11-08 17:30:00+00:00,1,49,-48,No Signal,11066.361328125
2022-11-08 18:30:00+00:00,2,19,-17,No Signal,10912.689453125
2022-11-08 19:30:00+00:00,1,23,-22,No Signal,11075.650390625
2022-11-08 20:30:00+00:00,1,15,-14,No Signal,11060.619140625
2022-11-09 14:30:00+00:00,0,11,-11,No Signal,10960.43359375
2022-11-09 15:30:00+00:00,4,9,-5,No Signal,10951.849609375
2022-11-09 16:30:00+00:00,4,8,-4,No Signal,10924.5283203125
2022-11-09 17:30:00+00:00,4,6,-2,No Signal,10883.8125
2022-11-09 18:30:00+00:00,7,6,1,No Signal,10867.4697265625
2022-11-09 19:30:00+00:00,9,3,6,No Signal,10839.8154296875
2022-11-09 20:30:00+00:00,9,1,8,No Signal,10798.994140625
2022-11-10 14:30:00+00:00,1,13,-12,No Signal,11390.5400390625
2022-11-10 15:30:00+00:00,2,7,-5,No Signal,11419.04296875
2022-11-10 16:30:00+00:00,1,9,-8,No Signal,11438.087890625
2022-11-10 17:30:00+00:00,1,21,-20,No Signal,11438.47265625
2022-11-10 18:30:00+00:00,2,50,-48,No Signal,11473.2421875
2022-11-10 19:30:00+00:00,1,45,-44,No Signal,11543.025390625
2022-11-10 20:30:00+00:00,1,49,-48,No Signal,11600.939453125
2022-11-11 14:30:00+00:00,5,67,-62,No Signal,11721.451171875
2022-11-11 15:30:00+00:00,6,58,-52,No Signal,11624.630859375
2022-11-11 16:30:00+00:00,5,61,-56,No Signal,11707.958984375
2022-11-11 17:30:00+00:00,2,63,-61,No Signal,11786.0576171875
2022-11-11 18:30:00+00:00,1,63,-62,No Signal,11820.83984375
2022-11-11 19:30:00+00:00,1,65,-64,No Signal,11800.849609375
2022-11-11 20:30:00+00:00,1,67,-66,No Signal,11812.646484375
2022-11-14 14:30:00+00:00,2,37,-35,No Signal,11746.734375
2022-11-14 15:30:00+00:00,3,31,-28,No Signal,11713.2548828125
2022-11-14 16:30:00+00:00,0,36,-36,No Signal,11787.658203125
2022-11-14 17:30:00+00:00,0,43,-43,No Signal,11847.15234375
2022-11-14 18:30:00+00:00,0,38,-38,No Signal,11849.15234375
2022-11-14 19:30:00+00:00,3,22,-19,No Signal,11790.263671875
2022-11-14 20:30:00+00:00,6,7,-1,No Signal,11696.033203125
2022-11-15 14:30:00+00:00,2,16,-14,No Signal,12005.0029296875
2022-11-15 15:30:00+00:00,0,24,-24,No Signal,11947.849609375
2022-11-15 16:30:00+00:00,0,17,-17,No Signal,11961.435546875
2022-11-15 17:30:00+00:00,0,7,-7,No Signal,11819.4091796875
2022-11-15 18:30:00+00:00,1,7,-6,No Signal,11876.234375
2022-11-15 19:30:00+00:00,2,8,-6,No Signal,11895.501953125
2022-11-15 20:30:00+00:00,2,6,-4,No Signal,11872.1181640625
2022-11-16 14:30:00+00:00,0,1,-1,No Signal,11715.447265625
2022-11-16 15:30:00+00:00,0,3,-3,No Signal,11732.384765625
2022-11-16 16:30:00+00:00,2,2,0,No Signal,11733.53515625
2022-11-16 17:30:00+00:00,2,2,0,No Signal,11757.947265625
2022-11-16 18:30:00+00:00,2,2,0,No Signal,11725.5947265625
2022-11-16 19:30:00+00:00,2,2,0,No Signal,11691.6044921875
2022-11-16 20:30:00+00:00,1,4,-3,No Signal,11701.2919921875
2022-11-17 14:30:00+00:00,49,0,49,Long,11628.5849609375
2022-11-17 15:30:00+00:00,41,0,41,No Signal,11606.3583984375
2022-11-17 16:30:00+00:00,45,2,43,No Signal,11661.6943359375
2022-11-17 17:30:00+00:00,17,10,7,No Signal,11716.552734375
2022-11-17 18:30:00+00:00,35,4,31,No Signal,11653.552734375
2022-11-17 19:30:00+00:00,41,1,40,No Signal,11605.1240234375
2022-11-17 20:30:00+00:00,29,3,26,No Signal,11678.2197265625
2022-11-18 14:30:00+00:00,15,8,7,No Signal,11678.6357421875
2022-11-18 15:30:00+00:00,16,11,5,No Signal,11665.6376953125
2022-11-18 16:30:00+00:00,24,6,18,No Signal,11604.7451171875
2022-11-18 17:30:00+00:00,22,8,14,No Signal,11641.4755859375
2022-11-18 18:30:00+00:00,21,9,12,No Signal,11619.3837890625
2022-11-18 19:30:00+00:00,14,11,3,No Signal,11677.0693359375
2022-11-18 20:30:00+00:00,13,10,3,No Signal,11679.5849609375
2022-11-21 14:30:00+00:00,14,20,-6,No Signal,11577.48828125
2022-11-21 15:30:00+00:00,14,20,-6,No Signal,11574.330078125
2022-11-21 16:30:00+00:00,18,11,7,No Signal,11532.841796875
2022-11-21 17:30:00+00:00,18,10,8,No Signal,11575.4736328125
2022-11-21 18:30:00+00:00,17,13,4,No Signal,11560.53125
2022-11-21 19:30:00+00:00,14,19,-5,No Signal,11554.48828125
2022-11-21 20:30:00+00:00,23,14,9,No Signal,11553.44140625
2022-11-22 14:30:00+00:00,20,11,9,No Signal,11579.669921875
2022-11-22 15:30:00+00:00,17,9,8,No Signal,11615.0849609375
2022-11-22 16:30:00+00:00,10,19,-9,No Signal,11625.7490234375
2022-11-22 17:30:00+00:00,10,18,-8,No Signal,11662.646484375
2022-11-22 18:30:00+00:00,10,23,-13,Short,11660.505859375
2022-11-22 19:30:00+00:00,11,25,-14,No Signal,11701.8486328125
2022-11-22 20:30:00+00:00,9,24,-15,No Signal,11724.615234375
2022-11-23 14:30:00+00:00,0,46,-46,No Signal,11834.443359375
2022-11-23 15:30:00+00:00,0,46,-46,No Signal,11838.9052734375
2022-11-23 16:30:00+00:00,0,42,-42,No Signal,11781.6494140625
2022-11-23 17:30:00+00:00,0,31,-31,No Signal,11775.6201171875
2022-11-23 18:30:00+00:00,0,46,-46,No Signal,11842.5419921875
2022-11-23 19:30:00+00:00,0,51,-51,No Signal,11850.2587890625
2022-11-23 20:30:00+00:00,0,47,-47,No Signal,11841.4599609375
2022-11-25 14:30:00+00:00,0,29,-29,No Signal,11785.099609375
2022-11-25 15:30:00+00:00,0,28,-28,No Signal,11768.841796875
2022-11-25 16:30:00+00:00,1,28,-27,No Signal,11780.5439453125
2022-11-28 14:30:00+00:00,4,14,-10,No Signal,11678.423828125
2022-11-28 15:30:00+00:00,2,9,-7,No Signal,11671.18359375
2022-11-28 16:30:00+00:00,5,9,-4,No Signal,11676.734375
2022-11-28 17:30:00+00:00,6,8,-2,No Signal,11658.9755859375
2022-11-28 18:30:00+00:00,37,3,34,Long,11580.759765625
2022-11-28 19:30:00+00:00,47,2,45,No Signal,11559.298828125
2022-11-28 20:30:00+00:00,31,3,28,No Signal,11589.494140625
2022-11-29 14:30:00+00:00,28,6,22,No Signal,11603.509765625
2022-11-29 15:30:00+00:00,54,2,52,No Signal,11471.2265625
2022-11-29 16:30:00+00:00,52,2,50,No Signal,11496.814453125
2022-11-29 17:30:00+00:00,51,2,49,No Signal,11463.8076171875
2022-11-29 18:30:00+00:00,40,4,36,No Signal,11492.837890625
2022-11-29 19:30:00+00:00,37,4,33,No Signal,11494.7978515625
2022-11-29 20:30:00+00:00,37,4,33,No Signal,11504.931640625
2022-11-30 14:30:00+00:00,21,5,16,No Signal,11534.0791015625
2022-11-30 15:30:00+00:00,18,5,13,No Signal,11530.880859375
2022-11-30 16:30:00+00:00,23,4,19,No Signal,11499.0390625
2022-11-30 17:30:00+00:00,12,4,8,No Signal,11539.5283203125
2022-11-30 18:30:00+00:00,1,33,-32,Short,11890.166015625
2022-11-30 19:30:00+00:00,1,43,-42,No Signal,11950.2294921875
2022-11-30 20:30:00+00:00,2,45,-43,No Signal,12026.4091796875
2022-12-01 14:30:00+00:00,3,37,-34,No Signal,11947.1845703125
2022-12-01 15:30:00+00:00,0,62,-62,No Signal,12009.3408203125
2022-12-01 16:30:00+00:00,2,61,-59,No Signal,12017.455078125
2022-12-01 17:30:00+00:00,1,60,-59,No Signal,12015.83984375
2022-12-01 18:30:00+00:00,2,60,-58,No Signal,12042.9248046875
2022-12-01 19:30:00+00:00,1,62,-61,No Signal,12043.38671875
2022-12-01 20:30:00+00:00,0,64,-64,No Signal,12042.703125
2022-12-02 14:30:00+00:00,1,31,-30,No Signal,11890.20703125
2022-12-02 15:30:00+00:00,1,37,-36,No Signal,11912.16796875
2022-12-02 16:30:00+00:00,0,43,-43,No Signal,11925.6796875
2022-12-02 17:30:00+00:00,1,41,-40,No Signal,11910.44140625
2022-12-02 18:30:00+00:00,3,18,-15,No Signal,11919.9208984375
2022-12-02 19:30:00+00:00,2,17,-15,No Signal,11992.9833984375
2022-12-02 20:30:00+00:00,5,10,-5,No Signal,11994.8134765625
2022-12-05 14:30:00+00:00,13,7,6,No Signal,11872.2578125
2022-12-05 15:30:00+00:00,18,9,9,No Signal,11873.2998046875
2022-12-05 16:30:00+00:00,22,7,15,Long,11844.6796875
2022-12-05 17:30:00+00:00,25,6,19,No Signal,11813.7294921875
2022-12-05 18:30:00+00:00,36,3,33,No Signal,11761.708984375
2022-12-05 19:30:00+00:00,43,4,39,No Signal,11743.7099609375
2022-12-05 20:30:00+00:00,29,4,25,No Signal,11788.916015625
2022-12-06 14:30:00+00:00,36,2,34,No Signal,11616.275390625
2022-12-06 15:30:00+00:00,44,2,42,No Signal,11618.720703125
2022-12-06 16:30:00+00:00,54,2,52,No Signal,11586.9306640625
2022-12-06 17:30:00+00:00,60,1,59,No Signal,11546.677734375
2022-12-06 18:30:00+00:00,63,2,61,No Signal,11504.37890625
2022-12-06 19:30:00+00:00,78,1,77,No Signal,11495.9697265625
2022-12-06 20:30:00+00:00,62,2,60,No Signal,11551.0048828125
2022-12-07 14:30:00+00:00,41,4,37,No Signal,11502.564453125
2022-12-07 15:30:00+00:00,53,2,51,No Signal,11458.7158203125
2022-12-07 16:30:00+00:00,44,2,42,No Signal,11471.5302734375
2022-12-07 17:30:00+00:00,28,2,26,No Signal,11531.9365234375
2022-12-07 18:30:00+00:00,24,3,21,No Signal,11498.39453125
2022-12-07 19:30:00+00:00,20,0,20,No Signal,11482.1337890625
2022-12-07 20:30:00+00:00,28,0,28,No Signal,11496.134765625
2022-12-08 14:30:00+00:00,4,10,-6,No Signal,11637.5419921875
2022-12-08 15:30:00+00:00,6,8,-2,No Signal,11612.1767578125
2022-12-08 16:30:00+00:00,7,11,-4,No Signal,11597.634765625
2022-12-08 17:30:00+00:00,5,22,-17,Short,11640.7490234375
2022-12-08 18:30:00+00:00,5,20,-15,No Signal,11598.7255859375
2022-12-08 19:30:00+00:00,3,24,-21,No Signal,11648.9326171875
2022-12-08 20:30:00+00:00,5,21,-16,No Signal,11636.7197265625
2022-12-09 14:30:00+00:00,6,25,-19,No Signal,11620.3603515625
2022-12-09 15:30:00+00:00,4,31,-27,No Signal,11679.6845703125
2022-12-09 16:30:00+00:00,4,32,-28,No Signal,11683.802734375
2022-12-09 17:30:00+00:00,9,21,-12,No Signal,11643.064453125
2022-12-09 18:30:00+00:00,8,24,-16,No Signal,11655.1591796875
2022-12-09 19:30:00+00:00,8,25,-17,No Signal,11638.2958984375
2022-12-09 20:30:00+00:00,10,10,0,No Signal,11563.505859375
2022-12-12 14:30:00+00:00,24,4,20,Long,11569.8095703125
2022-12-12 15:30:00+00:00,19,8,11,No Signal,11576.2333984375
2022-12-12 16:30:00+00:00,14,9,5,No Signal,11578.626953125
2022-12-12 17:30:00+00:00,17,8,9,No Signal,11581.837890625
2022-12-12 18:30:00+00:00,12,6,6,No Signal,11595.1103515625
2022-12-12 19:30:00+00:00,9,11,-2,No Signal,11673.8623046875
2022-12-12 20:30:00+00:00,7,8,-1,No Signal,11705.5302734375
2022-12-13 14:30:00+00:00,4,45,-41,Short,11985.3486328125
2022-12-13 15:30:00+00:00,4,35,-31,No Signal,11964.857421875
2022-12-13 16:30:00+00:00,4,5,-1,No Signal,11763.84375
2022-12-13 17:30:00+00:00,4,8,-4,No Signal,11825.7568359375
2022-12-13 18:30:00+00:00,5,9,-4,No Signal,11823.525390625
2022-12-13 19:30:00+00:00,3,13,-10,No Signal,11824.935546875
2022-12-13 20:30:00+00:00,3,26,-23,No Signal,11832.01171875
2022-12-14 14:30:00+00:00,2,40,-38,No Signal,11907.2578125
2022-12-14 15:30:00+00:00,3,37,-34,No Signal,11921.42578125
2022-12-14 16:30:00+00:00,3,14,-11,No Signal,11880.7314453125
2022-12-14 17:30:00+00:00,2,17,-15,No Signal,11887.5947265625
2022-12-14 18:30:00+00:00,3,7,-4,No Signal,11755.3251953125
2022-12-14 19:30:00+00:00,10,6,4,No Signal,11720.0810546875
2022-12-14 20:30:00+00:00,9,5,4,No Signal,11740.599609375
2022-12-15 14:30:00+00:00,52,0,52,Long,11439.724609375
2022-12-15 15:30:00+00:00,52,1,51,No Signal,11385.3720703125
2022-12-15 16:30:00+00:00,39,1,38,No Signal,11374.646484375
2022-12-15 17:30:00+00:00,61,1,60,No Signal,11322.923828125
2022-12-15 18:30:00+00:00,60,0,60,No Signal,11316.0576171875
2022-12-15 19:30:00+00:00,50,0,50,No Signal,11382.015625
2022-12-15 20:30:00+00:00,53,0,53,No Signal,11352.177734375
2022-12-16 14:30:00+00:00,72,0,72,No Signal,11239.9951171875
2022-12-16 15:30:00+00:00,73,0,73,No Signal,11213.3271484375
2022-12-16 16:30:00+00:00,76,1,75,No Signal,11216.4443359375
2022-12-16 17:30:00+00:00,79,0,79,No Signal,11184.92578125
2022-12-16 18:30:00+00:00,75,0,75,No Signal,11195.43359375
2022-12-16 19:30:00+00:00,55,0,55,No Signal,11262.5498046875
2022-12-16 20:30:00+00:00,59,2,57,No Signal,11237.6748046875
2022-12-19 14:30:00+00:00,26,2,24,No Signal,11194.466796875
2022-12-19 15:30:00+00:00,29,1,28,No Signal,11122.6982421875
2022-12-19 16:30:00+00:00,33,3,30,No Signal,11107.0478515625
2022-12-19 17:30:00+00:00,25,1,24,No Signal,11127.9921875
2022-12-19 18:30:00+00:00,30,1,29,No Signal,11054.4189453125
2022-12-19 19:30:00+00:00,41,1,40,No Signal,11045.7626953125
2022-12-19 20:30:00+00:00,26,1,25,No Signal,11087.71484375
2022-12-20 14:30:00+00:00,7,5,2,No Signal,11106.671875
2022-12-20 15:30:00+00:00,16,1,15,No Signal,11012.3486328125
2022-12-20 16:30:00+00:00,7,0,7,No Signal,11082.53515625
2022-12-20 17:30:00+00:00,5,5,0,No Signal,11094.9521484375
2022-12-20 18:30:00+00:00,6,1,5,No Signal,11090.4052734375
2022-12-20 19:30:00+00:00,15,0,15,No Signal,11088.203125
2022-12-20 20:30:00+00:00,12,0,12,No Signal,11072.2197265625
2022-12-21 14:30:00+00:00,6,6,0,No Signal,11189.5244140625
2022-12-21 15:30:00+00:00,3,10,-7,No Signal,11241.7626953125
2022-12-21 16:30:00+00:00,3,10,-7,No Signal,11214.580078125
2022-12-21 17:30:00+00:00,3,11,-8,No Signal,11228.8798828125
2022-12-21 18:30:00+00:00,1,32,-31,Short,11259.072265625
2022-12-21 19:30:00+00:00,3,20,-17,No Signal,11224.236328125
2022-12-21 20:30:00+00:00,3,18,-15,No Signal,11234.5419921875
2022-12-22 14:30:00+00:00,11,4,7,No Signal,10936.48046875
2022-12-22 15:30:00+00:00,5,4,1,No Signal,10913.5439453125
2022-12-22 16:30:00+00:00,22,4,18,Long,10833.9541015625
2022-12-22 17:30:00+00:00,24,5,19,No Signal,10801.755859375
2022-12-22 18:30:00+00:00,12,3,9,No Signal,10861.9990234375
2022-12-22 19:30:00+00:00,5,4,1,No Signal,10948.5615234375
2022-12-22 20:30:00+00:00,4,3,1,No Signal,10958.009765625
2022-12-23 14:30:00+00:00,11,2,9,No Signal,10943.4140625
2022-12-23 15:30:00+00:00,27,2,25,No Signal,10924.583984375
2022-12-23 16:30:00+00:00,14,2,12,No Signal,10967.634765625
2022-12-23 17:30:00+00:00,20,3,17,No Signal,10957.1376953125
2022-12-23 18:30:00+00:00,23,2,21,No Signal,10954.673828125
2022-12-23 19:30:00+00:00,19,3,16,No Signal,10962.8369140625
2022-12-23 20:30:00+00:00,17,1,16,No Signal,10983.06640625
2022-12-27 14:30:00+00:00,6,10,-4,No Signal,10893.2021484375
2022-12-27 15:30:00+00:00,7,10,-3,No Signal,10887.1171875
2022-12-27 16:30:00+00:00,3,20,-17,Short,10867.07421875
2022-12-27 17:30:00+00:00,2,27,-25,No Signal,10852.5244140625
2022-12-27 18:30:00+00:00,9,16,-7,No Signal,10819.8515625
2022-12-27 19:30:00+00:00,18,14,4,No Signal,10848.9150390625
2022-12-27 20:30:00+00:00,17,10,7,No Signal,10823.283203125
2022-12-28 14:30:00+00:00,14,3,11,Long,10808.7529296875
2022-12-28 15:30:00+00:00,15,4,11,No Signal,10737.0361328125
2022-12-28 16:30:00+00:00,31,1,30,No Signal,10706.1826171875
2022-12-28 17:30:00+00:00,15,2,13,No Signal,10756.2607421875
2022-12-28 18:30:00+00:00,24,2,22,No Signal,10719.3828125
2022-12-28 19:30:00+00:00,25,2,23,No Signal,10684.173828125
2022-12-28 20:30:00+00:00,37,2,35,No Signal,10680.94921875
2022-12-29 14:30:00+00:00,3,2,1,No Signal,10904.9931640625
2022-12-29 15:30:00+00:00,2,4,-2,No Signal,10937.5302734375
2022-12-29 16:30:00+00:00,0,8,-8,No Signal,10956.58203125
2022-12-29 17:30:00+00:00,2,11,-9,No Signal,10943.962890625
2022-12-29 18:30:00+00:00,1,14,-13,Short,10950.2939453125
2022-12-29 19:30:00+00:00,3,11,-8,No Signal,10960.837890625
2022-12-29 20:30:00+00:00,1,14,-13,No Signal,10947.693359375
2022-12-30 14:30:00+00:00,4,10,-6,No Signal,10841.615234375
2022-12-30 15:30:00+00:00,4,14,-10,No Signal,10827.82421875
2022-12-30 16:30:00+00:00,0,15,-15,No Signal,10860.1748046875
2022-12-30 17:30:00+00:00,4,4,0,No Signal,10817.595703125
2022-12-30 18:30:00+00:00,6,14,-8,No Signal,10819.2451171875
2022-12-30 19:30:00+00:00,1,23,-22,No Signal,10859.8583984375
2022-12-30 20:30:00+00:00,0,35,-35,No Signal,10941.17578125
2023-01-03 14:30:00+00:00,5,12,-7,No Signal,10861.505859375
2023-01-03 15:30:00+00:00,10,8,2,No Signal,10834.0693359375
2023-01-03 16:30:00+00:00,22,3,19,Long,10794.8818359375
2023-01-03 17:30:00+00:00,13,4,9,No Signal,10820.927734375
2023-01-03 18:30:00+00:00,12,4,8,No Signal,10824.7021484375
2023-01-03 19:30:00+00:00,5,3,2,No Signal,10863.4130859375
2023-01-03 20:30:00+00:00,5,2,3,No Signal,10864.357421875
2023-01-04 14:30:00+00:00,4,21,-17,Short,10826.4130859375
2023-01-04 15:30:00+00:00,2,30,-28,No Signal,10909.70703125
2023-01-04 16:30:00+00:00,1,34,-33,No Signal,10956.908203125
2023-01-04 17:30:00+00:00,1,40,-39,No Signal,10941.525390625
2023-01-04 18:30:00+00:00,1,22,-21,No Signal,10832.48046875
2023-01-04 19:30:00+00:00,2,18,-16,No Signal,10877.748046875
2023-01-04 20:30:00+00:00,6,18,-12,No Signal,10919.0400390625
2023-01-05 14:30:00+00:00,7,13,-6,No Signal,10800.0712890625
2023-01-05 15:30:00+00:00,6,15,-9,No Signal,10770.67578125
2023-01-05 16:30:00+00:00,8,18,-10,No Signal,10779.3046875
2023-01-05 17:30:00+00:00,8,20,-12,No Signal,10807.7421875
2023-01-05 18:30:00+00:00,7,17,-10,No Signal,10784.0439453125
2023-01-05 19:30:00+00:00,14,14,0,No Signal,10760.3564453125
2023-01-05 20:30:00+00:00,15,16,-1,No Signal,10742.0673828125
2023-01-06 14:30:00+00:00,9,11,-2,No Signal,10815.2236328125
2023-01-06 15:30:00+00:00,8,11,-3,No Signal,10907.6787109375
2023-01-06 16:30:00+00:00,11,12,-1,No Signal,10942.138671875
2023-01-06 17:30:00+00:00,7,14,-7,No Signal,10962.8701171875
2023-01-06 18:30:00+00:00,5,33,-28,No Signal,11026.95703125
2023-01-06 19:30:00+00:00,5,30,-25,No Signal,11054.2587890625
2023-01-06 20:30:00+00:00,5,24,-19,No Signal,11036.2451171875
2023-01-09 14:30:00+00:00,4,55,-51,No Signal,11224.5380859375
2023-01-09 15:30:00+00:00,2,63,-61,No Signal,11294.875
2023-01-09 16:30:00+00:00,3,64,-61,No Signal,11289.509765625
2023-01-09 17:30:00+00:00,2,59,-57,No Signal,11280.8447265625
2023-01-09 18:30:00+00:00,2,56,-54,No Signal,11221.3984375
2023-01-09 19:30:00+00:00,3,48,-45,No Signal,11138.173828125
2023-01-09 20:30:00+00:00,5,47,-42,No Signal,11108.1494140625
2023-01-10 14:30:00+00:00,3,31,-28,No Signal,11132.08984375
2023-01-10 15:30:00+00:00,3,18,-15,No Signal,11118.392578125
2023-01-10 16:30:00+00:00,3,21,-18,No Signal,11117.265625
2023-01-10 17:30:00+00:00,3,17,-14,No Signal,11149.896484375
2023-01-10 18:30:00+00:00,3,17,-14,No Signal,11186.5693359375
2023-01-10 19:30:00+00:00,5,12,-7,No Signal,11165.509765625
2023-01-10 20:30:00+00:00,2,17,-15,No Signal,11204.8349609375
2023-01-11 14:30:00+00:00,3,10,-7,No Signal,11310.669921875
2023-01-11 15:30:00+00:00,10,7,3,No Signal,11294.376953125
2023-01-11 16:30:00+00:00,8,8,0,No Signal,11332.1103515625
2023-01-11 17:30:00+00:00,8,12,-4,No Signal,11341.0361328125
2023-01-11 18:30:00+00:00,5,14,-9,No Signal,11331.2041015625
2023-01-11 19:30:00+00:00,2,34,-32,No Signal,11363.990234375
2023-01-11 20:30:00+00:00,2,47,-45,No Signal,11400.6298828125
2023-01-12 14:30:00+00:00,3,35,-32,No Signal,11398.83203125
2023-01-12 15:30:00+00:00,4,34,-30,No Signal,11380.4892578125
2023-01-12 16:30:00+00:00,1,45,-44,No Signal,11469.5166015625
2023-01-12 17:30:00+00:00,2,31,-29,No Signal,11410.2490234375
2023-01-12 18:30:00+00:00,4,33,-29,No Signal,11465.017578125
2023-01-12 19:30:00+00:00,3,32,-29,No Signal,11445.861328125
2023-01-12 20:30:00+00:00,3,30,-27,No Signal,11459.8125
2023-01-13 14:30:00+00:00,3,24,-21,No Signal,11448.6337890625
2023-01-13 15:30:00+00:00,3,20,-17,No Signal,11419.146484375
2023-01-13 16:30:00+00:00,3,19,-16,No Signal,11447.6240234375
2023-01-13 17:30:00+00:00,3,18,-15,No Signal,11457.9326171875
2023-01-13 18:30:00+00:00,4,20,-16,No Signal,11500.11328125
2023-01-13 19:30:00+00:00,8,24,-16,No Signal,11527.158203125
2023-01-13 20:30:00+00:00,4,21,-17,No Signal,11539.4189453125
2023-01-17 14:30:00+00:00,1,33,-32,No Signal,11588.7255859375
2023-01-17 15:30:00+00:00,2,30,-28,No Signal,11515.58984375
2023-01-17 16:30:00+00:00,10,20,-10,No Signal,11530.3251953125
2023-01-17 17:30:00+00:00,3,33,-30,No Signal,11560.09765625
2023-01-17 18:30:00+00:00,11,27,-16,No Signal,11554.9775390625
2023-01-17 19:30:00+00:00,7,28,-21,No Signal,11560.857421875
2023-01-17 20:30:00+00:00,7,26,-19,No Signal,11556.7392578125
2023-01-18 14:30:00+00:00,10,36,-26,No Signal,11650.08203125
2023-01-18 15:30:00+00:00,15,9,6,No Signal,11500.2431640625
2023-01-18 16:30:00+00:00,15,2,13,Long,11457.349609375
2023-01-18 17:30:00+00:00,17,6,11,No Signal,11444.8349609375
2023-01-18 18:30:00+00:00,17,2,15,No Signal,11474.5595703125
2023-01-18 19:30:00+00:00,20,2,18,No Signal,11451.09375
2023-01-18 20:30:00+00:00,27,1,26,No Signal,11410.3662109375
2023-01-19 14:30:00+00:00,37,0,37,No Signal,11316.2021484375
2023-01-19 15:30:00+00:00,36,0,36,No Signal,11271.87109375
2023-01-19 16:30:00+00:00,34,0,34,No Signal,11284.4140625
2023-01-19 17:30:00+00:00,40,0,40,No Signal,11306.361328125
2023-01-19 18:30:00+00:00,33,0,33,No Signal,11370.013671875
2023-01-19 19:30:00+00:00,29,0,29,No Signal,11355.0048828125
2023-01-19 20:30:00+00:00,38,0,38,No Signal,11292.4169921875
2023-01-20 14:30:00+00:00,53,3,50,No Signal,11426.3251953125
2023-01-20 15:30:00+00:00,27,7,20,No Signal,11473.09375
2023-01-20 16:30:00+00:00,22,10,12,No Signal,11478.4921875
2023-01-20 17:30:00+00:00,22,7,15,No Signal,11465.2822265625
2023-01-20 18:30:00+00:00,10,9,1,No Signal,11553.490234375
2023-01-20 19:30:00+00:00,6,10,-4,No Signal,11595.236328125
2023-01-20 20:30:00+00:00,2,15,-13,Short,11614.166015625
2023-01-23 14:30:00+00:00,2,52,-50,No Signal,11788.9130859375
2023-01-23 15:30:00+00:00,2,68,-66,No Signal,11848.154296875
2023-01-23 16:30:00+00:00,1,64,-63,No Signal,11866.1015625
2023-01-23 17:30:00+00:00,1,65,-64,No Signal,11900.39453125
2023-01-23 18:30:00+00:00,1,57,-56,No Signal,11867.857421875
2023-01-23 19:30:00+00:00,1,58,-57,No Signal,11841.265625
2023-01-23 20:30:00+00:00,1,70,-69,No Signal,11870.908203125
2023-01-24 14:30:00+00:00,1,50,-49,No Signal,11836.1162109375
2023-01-24 15:30:00+00:00,1,52,-51,No Signal,11874.50390625
2023-01-24 16:30:00+00:00,1,51,-50,No Signal,11865.171875
2023-01-24 17:30:00+00:00,1,55,-54,No Signal,11852.1337890625
2023-01-24 18:30:00+00:00,1,46,-45,No Signal,11846.2529296875
2023-01-24 19:30:00+00:00,1,43,-42,No Signal,11844.6982421875
2023-01-24 20:30:00+00:00,2,40,-38,No Signal,11847.4052734375
2023-01-25 14:30:00+00:00,29,3,26,Long,11589.439453125
2023-01-25 15:30:00+00:00,19,6,13,No Signal,11664.533203125
2023-01-25 16:30:00+00:00,18,4,14,No Signal,11679.8173828125
2023-01-25 17:30:00+00:00,14,3,11,No Signal,11756.345703125
2023-01-25 18:30:00+00:00,10,6,4,No Signal,11789.5595703125
2023-01-25 19:30:00+00:00,9,10,-1,No Signal,11808.8896484375
2023-01-25 20:30:00+00:00,7,8,-1,No Signal,11813.44140625
2023-01-26 14:30:00+00:00,3,16,-13,Short,11967.2470703125
2023-01-26 15:30:00+00:00,5,9,-4,No Signal,11887.427734375
2023-01-26 16:30:00+00:00,3,11,-8,No Signal,11943.310546875
2023-01-26 17:30:00+00:00,2,13,-11,No Signal,11942.634765625
2023-01-26 18:30:00+00:00,3,15,-12,No Signal,11987.494140625
2023-01-26 19:30:00+00:00,3,16,-13,No Signal,12024.044921875
2023-01-26 20:30:00+00:00,5,16,-11,No Signal,12053.7412109375
2023-01-27 14:30:00+00:00,2,59,-57,No Signal,12110.6259765625
2023-01-27 15:30:00+00:00,4,53,-49,No Signal,12101.25
2023-01-27 16:30:00+00:00,4,51,-47,No Signal,12155.767578125
2023-01-27 17:30:00+00:00,4,48,-44,No Signal,12170.1181640625
2023-01-27 18:30:00+00:00,4,49,-45,No Signal,12208.376953125
2023-01-27 19:30:00+00:00,7,49,-42,No Signal,12234.056640625
2023-01-27 20:30:00+00:00,7,35,-28,No Signal,12166.6044921875
2023-01-30 14:30:00+00:00,6,6,0,No Signal,11993.8759765625
2023-01-30 15:30:00+00:00,3,9,-6,No Signal,12000.609375
2023-01-30 16:30:00+00:00,8,6,2,No Signal,11994.09765625
2023-01-30 17:30:00+00:00,9,5,4,No Signal,11986.0517578125
2023-01-30 18:30:00+00:00,12,3,9,No Signal,11948.2421875
2023-01-30 19:30:00+00:00,25,0,25,Long,11919.8173828125
2023-01-30 20:30:00+00:00,27,0,27,No Signal,11912.7158203125
2023-01-31 14:30:00+00:00,15,1,14,No Signal,12006.154296875
2023-01-31 15:30:00+00:00,8,0,8,No Signal,12030.669921875
2023-01-31 16:30:00+00:00,13,0,13,No Signal,12022.216796875
2023-01-31 17:30:00+00:00,18,2,16,No Signal,12021.9443359375
2023-01-31 18:30:00+00:00,18,2,16,No Signal,12046.880859375
2023-01-31 19:30:00+00:00,32,1,31,No Signal,12023.447265625
2023-01-31 20:30:00+00:00,13,7,6,No Signal,12102.796875
2023-02-01 14:30:00+00:00,5,15,-10,Short,12090.123046875
2023-02-01 15:30:00+00:00,6,11,-5,No Signal,12079.5517578125
2023-02-01 16:30:00+00:00,7,9,-2,No Signal,12066.330078125
2023-02-01 17:30:00+00:00,6,16,-10,No Signal,12085.6259765625
2023-02-01 18:30:00+00:00,5,22,-17,No Signal,12100.3798828125
2023-02-01 19:30:00+00:00,2,59,-57,No Signal,12377.1474609375
2023-02-01 20:30:00+00:00,2,59,-57,No Signal,12363.0576171875
2023-02-02 14:30:00+00:00,4,63,-59,No Signal,12683.6201171875
2023-02-02 15:30:00+00:00,4,65,-61,No Signal,12759.8388671875
2023-02-02 16:30:00+00:00,4,62,-58,No Signal,12763.4111328125
2023-02-02 17:30:00+00:00,3,59,-56,No Signal,12802.3857421875
2023-02-02 18:30:00+00:00,4,54,-50,No Signal,12765.6904296875
2023-02-02 19:30:00+00:00,3,56,-53,No Signal,12730.064453125
2023-02-02 20:30:00+00:00,4,52,-48,No Signal,12797.3115234375
2023-02-03 14:30:00+00:00,3,28,-25,No Signal,12738.615234375
2023-02-03 15:30:00+00:00,2,37,-35,No Signal,12792.07421875
2023-02-03 16:30:00+00:00,2,39,-37,No Signal,12780.900390625
2023-02-03 17:30:00+00:00,4,19,-15,No Signal,12645.099609375
2023-02-03 18:30:00+00:00,5,9,-4,No Signal,12602.0048828125
2023-02-03 19:30:00+00:00,11,3,8,No Signal,12580.212890625
2023-02-03 20:30:00+00:00,12,4,8,No Signal,12572.1279296875
2023-02-06 14:30:00+00:00,29,3,26,Long,12439.3603515625
2023-02-06 15:30:00+00:00,26,3,23,No Signal,12543.5791015625
2023-02-06 16:30:00+00:00,36,2,34,No Signal,12486.96484375
2023-02-06 17:30:00+00:00,43,2,41,No Signal,12468.6357421875
2023-02-06 18:30:00+00:00,33,4,29,No Signal,12500.0849609375
2023-02-06 19:30:00+00:00,38,2,36,No Signal,12440.080078125
2023-02-06 20:30:00+00:00,46,1,45,No Signal,12465.73828125
2023-02-07 14:30:00+00:00,37,0,37,No Signal,12452.369140625
2023-02-07 15:30:00+00:00,43,0,43,No Signal,12514.3486328125
2023-02-07 16:30:00+00:00,39,1,38,No Signal,12498.1162109375
2023-02-07 17:30:00+00:00,24,2,22,No Signal,12505.1669921875
2023-02-07 18:30:00+00:00,7,4,3,No Signal,12588.12890625
2023-02-07 19:30:00+00:00,2,9,-7,No Signal,12702.1669921875
2023-02-07 20:30:00+00:00,1,10,-9,No Signal,12728.4453125
2023-02-08 14:30:00+00:00,1,11,-10,Short,12624.5205078125
2023-02-08 15:30:00+00:00,8,4,4,No Signal,12492.4599609375
2023-02-08 16:30:00+00:00,4,8,-4,No Signal,12543.7021484375
2023-02-08 17:30:00+00:00,4,5,-1,No Signal,12531.4501953125
2023-02-08 18:30:00+00:00,5,6,-1,No Signal,12522.904296875
2023-02-08 19:30:00+00:00,5,7,-2,No Signal,12488.5556640625
2023-02-08 20:30:00+00:00,8,8,0,No Signal,12498.189453125
2023-02-09 14:30:00+00:00,3,21,-18,No Signal,12580.6650390625
2023-02-09 15:30:00+00:00,6,12,-6,No Signal,12540.443359375
2023-02-09 16:30:00+00:00,7,15,-8,No Signal,12543.7177734375
2023-02-09 17:30:00+00:00,7,11,-4,No Signal,12495.1005859375
2023-02-09 18:30:00+00:00,20,4,16,Long,12422.076171875
2023-02-09 19:30:00+00:00,44,1,43,No Signal,12363.6982421875
2023-02-09 20:30:00+00:00,41,1,40,No Signal,12383.2841796875
2023-02-10 14:30:00+00:00,28,3,25,No Signal,12339.2783203125
2023-02-10 15:30:00+00:00,24,5,19,No Signal,12287.67578125
2023-02-10 16:30:00+00:00,37,5,32,No Signal,12223.04296875
2023-02-10 17:30:00+00:00,20,4,16,No Signal,12301.0390625
2023-02-10 18:30:00+00:00,24,4,20,No Signal,12249.1162109375
2023-02-10 19:30:00+00:00,19,4,15,No Signal,12268.048828125
2023-02-10 20:30:00+00:00,15,6,9,No Signal,12305.6005859375
2023-02-13 14:30:00+00:00,18,4,14,No Signal,12418.7412109375
2023-02-13 15:30:00+00:00,11,12,-1,No Signal,12480.7861328125
2023-02-13 16:30:00+00:00,10,12,-2,No Signal,12497.76171875
2023-02-13 17:30:00+00:00,5,18,-13,Short,12510.068359375
2023-02-13 18:30:00+00:00,5,23,-18,No Signal,12480.5126953125
2023-02-13 19:30:00+00:00,4,24,-20,No Signal,12483.291015625
2023-02-13 20:30:00+00:00,4,28,-24,No Signal,12500.88671875
2023-02-14 14:30:00+00:00,4,28,-24,No Signal,12553.3349609375
2023-02-14 15:30:00+00:00,4,15,-11,No Signal,12432.873046875
2023-02-14 16:30:00+00:00,2,24,-22,No Signal,12459.7099609375
2023-02-14 17:30:00+00:00,1,25,-24,No Signal,12542.611328125
2023-02-14 18:30:00+00:00,2,39,-37,No Signal,12550.9794921875
2023-02-14 19:30:00+00:00,1,41,-40,No Signal,12588.5322265625
2023-02-14 20:30:00+00:00,2,37,-35,No Signal,12589.0712890625
2023-02-15 14:30:00+00:00,6,21,-15,No Signal,12538.0810546875
2023-02-15 15:30:00+00:00,7,22,-15,No Signal,12588.5048828125
2023-02-15 16:30:00+00:00,8,18,-10,No Signal,12574.2451171875
2023-02-15 17:30:00+00:00,8,23,-15,No Signal,12615.125
2023-02-15 18:30:00+00:00,6,27,-21,No Signal,12661.447265625
2023-02-15 19:30:00+00:00,4,24,-20,No Signal,12633.9453125
2023-02-15 20:30:00+00:00,1,25,-24,No Signal,12688.44140625
2023-02-16 14:30:00+00:00,7,10,-3,No Signal,12577.849609375
2023-02-16 15:30:00+00:00,2,26,-24,No Signal,12604.3681640625
2023-02-16 16:30:00+00:00,5,22,-17,No Signal,12614.5595703125
2023-02-16 17:30:00+00:00,7,16,-9,No Signal,12592.2109375
2023-02-16 18:30:00+00:00,6,17,-11,No Signal,12616.26171875
2023-02-16 19:30:00+00:00,12,5,7,No Signal,12479.11328125
2023-02-16 20:30:00+00:00,16,5,11,Long,12440.1923828125
2023-02-17 14:30:00+00:00,20,5,15,No Signal,12318.5771484375
2023-02-17 15:30:00+00:00,35,1,34,No Signal,12258.9365234375
2023-02-17 16:30:00+00:00,32,2,30,No Signal,12278.16015625
2023-02-17 17:30:00+00:00,46,1,45,No Signal,12251.166015625
2023-02-17 18:30:00+00:00,45,1,44,No Signal,12308.32421875
2023-02-17 19:30:00+00:00,40,1,39,No Signal,12326.4931640625
2023-02-17 20:30:00+00:00,45,1,44,No Signal,12357.822265625
2023-02-21 14:30:00+00:00,55,3,52,No Signal,12154.5
2023-02-21 15:30:00+00:00,60,2,58,No Signal,12127.994140625
2023-02-21 16:30:00+00:00,62,2,60,No Signal,12112.3994140625
2023-02-21 17:30:00+00:00,60,0,60,No Signal,12113.703125
2023-02-21 18:30:00+00:00,66,1,65,No Signal,12088.0078125
2023-02-21 19:30:00+00:00,57,2,55,No Signal,12076.154296875
2023-02-21 20:30:00+00:00,55,3,52,No Signal,12059.087890625
2023-02-22 14:30:00+00:00,45,2,43,No Signal,12034.1328125
2023-02-22 15:30:00+00:00,32,2,30,No Signal,12060.1083984375
2023-02-22 16:30:00+00:00,33,4,29,No Signal,12088.6630859375
2023-02-22 17:30:00+00:00,23,5,18,No Signal,12133.96875
2023-02-22 18:30:00+00:00,36,3,33,No Signal,12088.5224609375
2023-02-22 19:30:00+00:00,49,3,46,No Signal,12044.4794921875
2023-02-22 20:30:00+00:00,49,2,47,No Signal,12068.2333984375
2023-02-23 14:30:00+00:00,23,9,14,No Signal,12164.9833984375
2023-02-23 15:30:00+00:00,30,4,26,No Signal,12056.0244140625
2023-02-23 16:30:00+00:00,31,6,25,No Signal,12035.5419921875
2023-02-23 17:30:00+00:00,22,5,17,No Signal,12055.6025390625
2023-02-23 18:30:00+00:00,12,8,4,No Signal,12155.5986328125
2023-02-23 19:30:00+00:00,7,10,-3,No Signal,12214.701171875
2023-02-23 20:30:00+00:00,6,11,-5,No Signal,12179.4150390625
2023-02-24 14:30:00+00:00,18,5,13,No Signal,11933.0634765625
2023-02-24 15:30:00+00:00,22,4,18,No Signal,11949.5302734375
2023-02-24 16:30:00+00:00,23,3,20,No Signal,11947.3125
2023-02-24 17:30:00+00:00,28,2,26,No Signal,11933.75390625
2023-02-24 18:30:00+00:00,19,2,17,No Signal,11944.556640625
2023-02-24 19:30:00+00:00,17,2,15,No Signal,11951.2412109375
2023-02-24 20:30:00+00:00,14,3,11,No Signal,11971.7919921875
2023-02-27 14:30:00+00:00,5,1,4,No Signal,12129.9873046875
2023-02-27 15:30:00+00:00,6,3,3,No Signal,12067.357421875
2023-02-27 16:30:00+00:00,4,4,0,No Signal,12069.4013671875
2023-02-27 17:30:00+00:00,3,4,-1,No Signal,12092.8095703125
2023-02-27 18:30:00+00:00,8,2,6,No Signal,12093.740234375
2023-02-27 19:30:00+00:00,19,0,19,No Signal,12063.5283203125
2023-02-27 20:30:00+00:00,15,2,13,No Signal,12057.5498046875
2023-02-28 14:30:00+00:00,3,23,-20,Short,12044.7705078125
2023-02-28 15:30:00+00:00,4,20,-16,No Signal,12075.208984375
2023-02-28 16:30:00+00:00,3,22,-19,No Signal,12095.59765625
2023-02-28 17:30:00+00:00,1,27,-26,No Signal,12134.900390625
2023-02-28 18:30:00+00:00,3,25,-22,No Signal,12117.697265625
2023-02-28 19:30:00+00:00,2,20,-18,No Signal,12068.7158203125
2023-02-28 20:30:00+00:00,3,12,-9,No Signal,12041.203125
2023-03-01 14:30:00+00:00,28,5,23,Long,11953.14453125
2023-03-01 15:30:00+00:00,27,7,20,No Signal,11933.8046875
2023-03-01 16:30:00+00:00,15,11,4,No Signal,11990.5517578125
2023-03-01 17:30:00+00:00,24,4,20,No Signal,11955.2119140625
2023-03-01 18:30:00+00:00,26,3,23,No Signal,11928.3486328125
2023-03-01 19:30:00+00:00,20,4,16,No Signal,11923.6708984375
2023-03-01 20:30:00+00:00,17,6,11,No Signal,11940.193359375
2023-03-02 14:30:00+00:00,17,6,11,No Signal,11896.17578125
2023-03-02 15:30:00+00:00,24,6,18,No Signal,11875.259765625
2023-03-02 16:30:00+00:00,23,8,15,No Signal,11891.640625
2023-03-02 17:30:00+00:00,25,8,17,No Signal,11897.6044921875
2023-03-02 18:30:00+00:00,5,12,-7,No Signal,12022.177734375
2023-03-02 19:30:00+00:00,3,14,-11,Short,12029.9365234375
2023-03-02 20:30:00+00:00,3,18,-15,No Signal,12043.2578125
2023-03-03 14:30:00+00:00,0,34,-34,No Signal,12203.111328125
2023-03-03 15:30:00+00:00,1,45,-44,No Signal,12179.51171875
2023-03-03 16:30:00+00:00,1,40,-39,No Signal,12212.298828125
2023-03-03 17:30:00+00:00,0,55,-55,No Signal,12245.7373046875
2023-03-03 18:30:00+00:00,0,60,-60,No Signal,12280.201171875
2023-03-03 19:30:00+00:00,0,60,-60,No Signal,12285.9775390625
2023-03-03 20:30:00+00:00,0,57,-57,No Signal,12289.787109375
2023-03-06 14:30:00+00:00,1,68,-67,No Signal,12416.7216796875
2023-03-06 15:30:00+00:00,1,72,-71,No Signal,12431.26953125
2023-03-06 16:30:00+00:00,1,68,-67,No Signal,12429.6552734375
2023-03-06 17:30:00+00:00,1,61,-60,No Signal,12378.328125
2023-03-06 18:30:00+00:00,5,36,-31,No Signal,12341.1103515625
2023-03-06 19:30:00+00:00,5,30,-25,No Signal,12301.6552734375
2023-03-06 20:30:00+00:00,5,31,-26,No Signal,12303.822265625
2023-03-07 14:30:00+00:00,8,9,-1,No Signal,12224.65625
2023-03-07 15:30:00+00:00,10,4,6,No Signal,12203.6162109375
2023-03-07 16:30:00+00:00,10,4,6,No Signal,12267.615234375
2023-03-07 17:30:00+00:00,19,4,15,Long,12217.4033203125
2023-03-07 18:30:00+00:00,25,4,21,No Signal,12158.75390625
2023-03-07 19:30:00+00:00,32,1,31,No Signal,12137.9609375
2023-03-07 20:30:00+00:00,30,2,28,No Signal,12153.30859375
2023-03-08 14:30:00+00:00,36,1,35,No Signal,12174.865234375
2023-03-08 15:30:00+00:00,36,1,35,No Signal,12186.6220703125
2023-03-08 16:30:00+00:00,43,2,41,No Signal,12178.59375
2023-03-08 17:30:00+00:00,40,1,39,No Signal,12142.6142578125
2023-03-08 18:30:00+00:00,32,2,30,No Signal,12181.7529296875
2023-03-08 19:30:00+00:00,25,3,22,No Signal,12156.5927734375
2023-03-08 20:30:00+00:00,16,2,14,No Signal,12215.2421875
2023-03-09 14:30:00+00:00,13,15,-2,No Signal,12296.791015625
2023-03-09 15:30:00+00:00,13,15,-2,No Signal,12273.8681640625
2023-03-09 16:30:00+00:00,15,12,3,No Signal,12275.1953125
2023-03-09 17:30:00+00:00,15,5,10,No Signal,12159.0517578125
2023-03-09 18:30:00+00:00,16,2,14,No Signal,12088.373046875
2023-03-09 19:30:00+00:00,24,0,24,No Signal,11989.6748046875
2023-03-09 20:30:00+00:00,24,1,23,No Signal,11996.904296875
2023-03-10 14:30:00+00:00,39,2,37,No Signal,11914.39453125
2023-03-10 15:30:00+00:00,17,1,16,No Signal,12036.228515625
2023-03-10 16:30:00+00:00,31,1,30,No Signal,11934.384765625
2023-03-10 17:30:00+00:00,35,0,35,No Signal,11841.3095703125
2023-03-10 18:30:00+00:00,50,1,49,No Signal,11809.236328125
2023-03-10 19:30:00+00:00,35,1,34,No Signal,11859.94140625
2023-03-10 20:30:00+00:00,53,0,53,No Signal,11832.80859375
2023-03-13 13:30:00+00:00,61,0,61,No Signal,11851.765625
2023-03-13 14:30:00+00:00,17,3,14,No Signal,12032.6328125
2023-03-13 15:30:00+00:00,24,2,22,No Signal,12002.767578125
2023-03-13 16:30:00+00:00,20,2,18,No Signal,11951.8759765625
2023-03-13 17:30:00+00:00,5,3,2,No Signal,12037.8427734375
2023-03-13 18:30:00+00:00,4,3,1,No Signal,11960.0322265625
2023-03-13 19:30:00+00:00,4,2,2,No Signal,11921.939453125
2023-03-14 13:30:00+00:00,0,3,-3,No Signal,12169.3125
2023-03-14 14:30:00+00:00,1,3,-2,No Signal,12202.4404296875
2023-03-14 15:30:00+00:00,0,7,-7,No Signal,12178.1337890625
2023-03-14 16:30:00+00:00,0,10,-10,Short,12137.83984375
2023-03-14 17:30:00+00:00,0,13,-13,No Signal,12119.0615234375
2023-03-14 18:30:00+00:00,0,10,-10,No Signal,12070.228515625
2023-03-14 19:30:00+00:00,0,14,-14,No Signal,12197.69921875
2023-03-15 13:30:00+00:00,1,7,-6,No Signal,12087.373046875
2023-03-15 14:30:00+00:00,9,3,6,No Signal,12113.0166015625
2023-03-15 15:30:00+00:00,7,4,3,No Signal,12090.7841796875
2023-03-15 16:30:00+00:00,4,9,-5,No Signal,12151.9453125
2023-03-15 17:30:00+00:00,5,10,-5,No Signal,12221.486328125
2023-03-15 18:30:00+00:00,2,18,-16,No Signal,12250.2890625
2023-03-15 19:30:00+00:00,3,19,-16,No Signal,12252.46484375
2023-03-16 13:30:00+00:00,9,11,-2,No Signal,12276.7294921875
2023-03-16 14:30:00+00:00,2,16,-14,No Signal,12460.9931640625
2023-03-16 15:30:00+00:00,2,13,-11,No Signal,12502.3701171875
2023-03-16 16:30:00+00:00,1,17,-16,No Signal,12529.9833984375
2023-03-16 17:30:00+00:00,0,20,-20,No Signal,12532.3720703125
2023-03-16 18:30:00+00:00,0,34,-34,No Signal,12592.3349609375
2023-03-16 19:30:00+00:00,0,20,-20,No Signal,12579.8671875
2023-03-17 13:30:00+00:00,1,37,-36,No Signal,12556.0810546875
2023-03-17 14:30:00+00:00,2,28,-26,No Signal,12476.591796875
2023-03-17 15:30:00+00:00,0,35,-35,No Signal,12513.7529296875
2023-03-17 16:30:00+00:00,3,35,-32,No Signal,12538.376953125
2023-03-17 17:30:00+00:00,3,21,-18,No Signal,12483.146484375
2023-03-17 18:30:00+00:00,4,22,-18,No Signal,12533.291015625
2023-03-17 19:30:00+00:00,3,22,-19,No Signal,12519.59765625
2023-03-20 13:30:00+00:00,1,20,-19,No Signal,12480.9140625
2023-03-20 14:30:00+00:00,4,8,-4,No Signal,12562.8955078125
2023-03-20 15:30:00+00:00,7,4,3,No Signal,12475.4404296875
2023-03-20 16:30:00+00:00,7,5,2,No Signal,12524.49609375
2023-03-20 17:30:00+00:00,3,4,-1,No Signal,12537.6884765625
2023-03-20 18:30:00+00:00,5,4,1,No Signal,12532.953125
2023-03-20 19:30:00+00:00,4,5,-1,No Signal,12561.2109375
2023-03-21 13:30:00+00:00,4,18,-14,No Signal,12619.1162109375
2023-03-21 14:30:00+00:00,2,28,-26,No Signal,12625.099609375
2023-03-21 15:30:00+00:00,2,19,-17,No Signal,12636.63671875
2023-03-21 16:30:00+00:00,3,20,-17,No Signal,12672.4482421875
2023-03-21 17:30:00+00:00,2,33,-31,No Signal,12676.19140625
2023-03-21 18:30:00+00:00,1,34,-33,No Signal,12727.1904296875
2023-03-21 19:30:00+00:00,3,38,-35,No Signal,12738.5546875
2023-03-22 13:30:00+00:00,3,31,-28,No Signal,12801.15234375
2023-03-22 14:30:00+00:00,3,20,-17,No Signal,12786.87890625
2023-03-22 15:30:00+00:00,3,32,-29,No Signal,12752.220703125
2023-03-22 16:30:00+00:00,6,25,-19,No Signal,12773.42578125
2023-03-22 17:30:00+00:00,5,33,-28,No Signal,12852.591796875
2023-03-22 18:30:00+00:00,6,28,-22,No Signal,12819.1142578125
2023-03-22 19:30:00+00:00,16,0,16,Long,12566.2783203125
2023-03-23 13:30:00+00:00,9,4,5,No Signal,12807.9365234375
2023-03-23 14:30:00+00:00,2,7,-5,No Signal,12845.4111328125
2023-03-23 15:30:00+00:00,4,7,-3,No Signal,12855.9755859375
2023-03-23 16:30:00+00:00,5,3,2,No Signal,12791.8310546875
2023-03-23 17:30:00+00:00,11,2,9,No Signal,12688.421875
2023-03-23 18:30:00+00:00,16,1,15,No Signal,12671.2373046875
2023-03-23 19:30:00+00:00,16,3,13,No Signal,12729.93359375
2023-03-24 13:30:00+00:00,9,3,6,No Signal,12698.0673828125
2023-03-24 14:30:00+00:00,12,2,10,No Signal,12628.5537109375
2023-03-24 15:30:00+00:00,7,5,2,No Signal,12651.388671875
2023-03-24 16:30:00+00:00,4,4,0,No Signal,12692.236328125
2023-03-24 17:30:00+00:00,10,4,6,No Signal,12707.884765625
2023-03-24 18:30:00+00:00,4,5,-1,No Signal,12758.0009765625
2023-03-24 19:30:00+00:00,1,20,-19,Short,12768.30859375
2023-03-27 13:30:00+00:00,9,13,-4,No Signal,12775.2607421875
2023-03-27 14:30:00+00:00,19,6,13,Long,12725.9951171875
2023-03-27 15:30:00+00:00,17,5,12,No Signal,12693.5615234375
2023-03-27 16:30:00+00:00,11,15,-4,No Signal,12682.296875
2023-03-27 17:30:00+00:00,6,23,-17,Short,12710.5029296875
2023-03-27 18:30:00+00:00,6,30,-24,No Signal,12719.677734375
2023-03-27 19:30:00+00:00,15,20,-5,No Signal,12673.2431640625
2023-03-28 13:30:00+00:00,19,22,-3,No Signal,12582.412109375
2023-03-28 14:30:00+00:00,9,35,-26,No Signal,12589.7392578125
2023-03-28 15:30:00+00:00,14,19,-5,No Signal,12559.958984375
2023-03-28 16:30:00+00:00,13,15,-2,No Signal,12566.8681640625
2023-03-28 17:30:00+00:00,17,6,11,Long,12548.7861328125
2023-03-28 18:30:00+00:00,22,5,17,No Signal,12568.6181640625
2023-03-28 19:30:00+00:00,16,9,7,No Signal,12611.04296875
2023-03-29 13:30:00+00:00,8,15,-7,No Signal,12766.7783203125
2023-03-29 14:30:00+00:00,6,16,-10,Short,12775.6328125
2023-03-29 15:30:00+00:00,3,21,-18,No Signal,12800.962890625
2023-03-29 16:30:00+00:00,4,22,-18,No Signal,12813.0947265625
2023-03-29 17:30:00+00:00,6,17,-11,No Signal,12797.73046875
2023-03-29 18:30:00+00:00,4,25,-21,No Signal,12857.904296875
2023-03-29 19:30:00+00:00,2,27,-25,No Signal,12842.9189453125
2023-03-30 13:30:00+00:00,2,57,-55,No Signal,12971.943359375
2023-03-30 14:30:00+00:00,2,51,-49,No Signal,12958.4521484375
2023-03-30 15:30:00+00:00,2,51,-49,No Signal,12944.392578125
2023-03-30 16:30:00+00:00,4,47,-43,No Signal,12927.9130859375
2023-03-30 17:30:00+00:00,3,57,-54,No Signal,12942.7998046875
2023-03-30 18:30:00+00:00,3,62,-59,No Signal,12962.1064453125
2023-03-30 19:30:00+00:00,5,55,-50,No Signal,12960.501953125
2023-03-31 13:30:00+00:00,2,48,-46,No Signal,13028.9970703125
2023-03-31 14:30:00+00:00,2,57,-55,No Signal,13065.4833984375
2023-03-31 15:30:00+00:00,2,57,-55,No Signal,13113.30078125
2023-03-31 16:30:00+00:00,2,46,-44,No Signal,13101.353515625
2023-03-31 17:30:00+00:00,2,44,-42,No Signal,13110.318359375
2023-03-31 18:30:00+00:00,2,53,-51,No Signal,13175.1015625
2023-03-31 19:30:00+00:00,3,51,-48,No Signal,13176.59765625
2023-04-03 13:30:00+00:00,5,24,-19,No Signal,13140.6103515625
2023-04-03 14:30:00+00:00,5,19,-14,No Signal,13066.8291015625
2023-04-03 15:30:00+00:00,6,31,-25,No Signal,13072.197265625
2023-04-03 16:30:00+00:00,5,29,-24,No Signal,13043.1318359375
2023-04-03 17:30:00+00:00,4,25,-21,No Signal,13064.5478515625
2023-04-03 18:30:00+00:00,4,24,-20,No Signal,13124.783203125
2023-04-03 19:30:00+00:00,4,24,-20,No Signal,13146.6748046875
2023-04-04 13:30:00+00:00,5,15,-10,No Signal,13153.4638671875
2023-04-04 14:30:00+00:00,11,12,-1,No Signal,13117.326171875
2023-04-04 15:30:00+00:00,24,6,18,Long,13096.96875
2023-04-04 16:30:00+00:00,16,8,8,No Signal,13117.15625
2023-04-04 17:30:00+00:00,19,5,14,No Signal,13080.236328125
2023-04-04 18:30:00+00:00,33,4,29,No Signal,13066.0419921875
2023-04-04 19:30:00+00:00,26,5,21,No Signal,13100.8642578125
2023-04-05 13:30:00+00:00,34,8,26,No Signal,12978.3388671875
2023-04-05 14:30:00+00:00,36,9,27,No Signal,12925.4658203125
2023-04-05 15:30:00+00:00,35,7,28,No Signal,12903.251953125
2023-04-05 16:30:00+00:00,31,9,22,No Signal,12926.9306640625
2023-04-05 17:30:00+00:00,28,9,19,No Signal,12941.3681640625
2023-04-05 18:30:00+00:00,36,8,28,No Signal,12941.6865234375
2023-04-05 19:30:00+00:00,39,8,31,No Signal,12966.7646484375
2023-04-06 13:30:00+00:00,47,8,39,No Signal,12918.7470703125
2023-04-06 14:30:00+00:00,36,10,26,No Signal,12962.876953125
2023-04-06 15:30:00+00:00,21,14,7,No Signal,13028.0859375
2023-04-06 16:30:00+00:00,25,14,11,No Signal,13037.36328125
2023-04-06 17:30:00+00:00,18,14,4,No Signal,13071.3583984375
2023-04-06 18:30:00+00:00,17,14,3,No Signal,13061.7099609375
2023-04-06 19:30:00+00:00,24,12,12,No Signal,13060.9638671875
2023-04-10 13:30:00+00:00,16,3,13,No Signal,12886.5595703125
2023-04-10 14:30:00+00:00,4,10,-6,No Signal,12955.6982421875
2023-04-10 15:30:00+00:00,7,9,-2,No Signal,12937.359375
2023-04-10 16:30:00+00:00,2,13,-11,Short,13023.1611328125
2023-04-10 17:30:00+00:00,3,14,-11,No Signal,13030.01171875
2023-04-10 18:30:00+00:00,2,12,-10,No Signal,13027.271484375
2023-04-10 19:30:00+00:00,1,11,-10,No Signal,13046.6376953125
2023-04-11 13:30:00+00:00,2,20,-18,No Signal,12996.7529296875
2023-04-11 14:30:00+00:00,3,18,-15,No Signal,12967.416015625
2023-04-11 15:30:00+00:00,7,17,-10,No Signal,12977.3193359375
2023-04-11 16:30:00+00:00,5,16,-11,No Signal,12991.94921875
2023-04-11 17:30:00+00:00,1,16,-15,No Signal,13016.244140625
2023-04-11 18:30:00+00:00,3,20,-17,No Signal,13013.5244140625
2023-04-11 19:30:00+00:00,4,14,-10,No Signal,12964.923828125
2023-04-12 13:30:00+00:00,2,39,-37,No Signal,13011.0185546875
2023-04-12 14:30:00+00:00,4,17,-13,No Signal,12919.525390625
2023-04-12 15:30:00+00:00,3,18,-15,No Signal,12971.8857421875
2023-04-12 16:30:00+00:00,5,13,-8,No Signal,12984.2880859375
2023-04-12 17:30:00+00:00,8,9,-1,No Signal,12913.5244140625
2023-04-12 18:30:00+00:00,16,5,11,Long,12845.7841796875
2023-04-12 19:30:00+00:00,16,3,13,No Signal,12848.962890625
2023-04-13 13:30:00+00:00,13,6,7,No Signal,13028.0458984375
2023-04-13 14:30:00+00:00,12,9,3,No Signal,13026.3251953125
2023-04-13 15:30:00+00:00,7,4,3,No Signal,13052.9462890625
2023-04-13 16:30:00+00:00,4,3,1,No Signal,13060.560546875
2023-04-13 17:30:00+00:00,4,6,-2,No Signal,13100.9873046875
2023-04-13 18:30:00+00:00,5,6,-1,No Signal,13116.4736328125
2023-04-13 19:30:00+00:00,4,8,-4,No Signal,13108.2646484375
2023-04-14 13:30:00+00:00,5,2,3,No Signal,13043.671875
2023-04-14 14:30:00+00:00,4,10,-6,No Signal,13036.98828125
2023-04-14 15:30:00+00:00,8,6,2,No Signal,13008.908203125
2023-04-14 16:30:00+00:00,9,3,6,No Signal,12986.42578125
2023-04-14 17:30:00+00:00,1,10,-9,No Signal,13053.1337890625
2023-04-14 18:30:00+00:00,2,23,-21,Short,13057.9208984375
2023-04-14 19:30:00+00:00,1,26,-25,No Signal,13080.943359375
2023-04-17 13:30:00+00:00,6,18,-12,No Signal,13055.505859375
2023-04-17 14:30:00+00:00,8,12,-4,No Signal,13021.9560546875
2023-04-17 15:30:00+00:00,12,9,3,No Signal,12995.908203125
2023-04-17 16:30:00+00:00,10,9,1,No Signal,13021.1455078125
2023-04-17 17:30:00+00:00,11,7,4,No Signal,13008.21875
2023-04-17 18:30:00+00:00,11,9,2,No Signal,13075.078125
2023-04-17 19:30:00+00:00,8,9,-1,No Signal,13086.822265625
2023-04-18 13:30:00+00:00,5,17,-12,No Signal,13079.9423828125
2023-04-18 14:30:00+00:00,6,22,-16,No Signal,13087.8544921875
2023-04-18 15:30:00+00:00,5,25,-20,No Signal,13100.6708984375
2023-04-18 16:30:00+00:00,7,26,-19,No Signal,13073.8486328125
2023-04-18 17:30:00+00:00,7,22,-15,No Signal,13090.595703125
2023-04-18 18:30:00+00:00,7,22,-15,No Signal,13076.640625
2023-04-18 19:30:00+00:00,8,19,-11,No Signal,13093.828125
2023-04-19 13:30:00+00:00,14,5,9,No Signal,13020.8544921875
2023-04-19 14:30:00+00:00,11,7,4,No Signal,13052.630859375
2023-04-19 15:30:00+00:00,5,14,-9,No Signal,13094.4833984375
2023-04-19 16:30:00+00:00,8,13,-5,No Signal,13111.5986328125
2023-04-19 17:30:00+00:00,8,13,-5,No Signal,13107.8837890625
2023-04-19 18:30:00+00:00,15,12,3,No Signal,13106.7822265625
2023-04-19 19:30:00+00:00,19,10,9,No Signal,13088.6123046875
2023-04-20 13:30:00+00:00,19,10,9,No Signal,13042.8896484375
2023-04-20 14:30:00+00:00,20,14,6,No Signal,13033.576171875
2023-04-20 15:30:00+00:00,22,16,6,No Signal,13055.8837890625
2023-04-20 16:30:00+00:00,11,26,-15,No Signal,13101.396484375
2023-04-20 17:30:00+00:00,18,10,8,No Signal,13018.4208984375
2023-04-20 18:30:00+00:00,25,2,23,Long,12936.390625
2023-04-20 19:30:00+00:00,17,2,15,No Signal,12984.9072265625
2023-04-21 13:30:00+00:00,15,8,7,No Signal,12974.220703125
2023-04-21 14:30:00+00:00,13,6,7,No Signal,12977.8271484375
2023-04-21 15:30:00+00:00,18,4,14,No Signal,12980.7744140625
2023-04-21 16:30:00+00:00,24,3,21,No Signal,12983.5185546875
2023-04-21 17:30:00+00:00,12,6,6,No Signal,13017.4365234375
2023-04-21 18:30:00+00:00,17,6,11,No Signal,12986.630859375
2023-04-21 19:30:00+00:00,9,4,5,No Signal,13001.7158203125
2023-04-24 13:30:00+00:00,6,7,-1,No Signal,13003.13671875
2023-04-24 14:30:00+00:00,13,2,11,No Signal,12911.85546875
2023-04-24 15:30:00+00:00,15,2,13,No Signal,12916.236328125
2023-04-24 16:30:00+00:00,18,1,17,No Signal,12932.5341796875
2023-04-24 17:30:00+00:00,9,2,7,No Signal,12963.421875
2023-04-24 18:30:00+00:00,6,12,-6,No Signal,12963.4951171875
2023-04-24 19:30:00+00:00,7,10,-3,No Signal,12968.513671875
2023-04-25 13:30:00+00:00,24,9,15,No Signal,12863.7490234375
2023-04-25 14:30:00+00:00,27,9,18,No Signal,12869.8330078125
2023-04-25 15:30:00+00:00,34,8,26,No Signal,12827.6396484375
2023-04-25 16:30:00+00:00,36,7,29,No Signal,12800.5732421875
2023-04-25 17:30:00+00:00,45,3,42,No Signal,12774.4208984375
2023-04-25 18:30:00+00:00,44,4,40,No Signal,12760.919921875
2023-04-25 19:30:00+00:00,53,4,49,No Signal,12726.6591796875
2023-04-26 13:30:00+00:00,54,2,52,No Signal,12838.9619140625
2023-04-26 14:30:00+00:00,39,6,33,No Signal,12894.68359375
2023-04-26 15:30:00+00:00,38,5,33,No Signal,12911.3251953125
2023-04-26 16:30:00+00:00,42,5,37,No Signal,12869.283203125
2023-04-26 17:30:00+00:00,52,5,47,No Signal,12841.880859375
2023-04-26 18:30:00+00:00,55,3,52,No Signal,12809.4892578125
2023-04-26 19:30:00+00:00,57,0,57,No Signal,12806.8994140625
2023-04-27 13:30:00+00:00,31,8,23,No Signal,13001.76953125
2023-04-27 14:30:00+00:00,27,10,17,No Signal,13061.0517578125
2023-04-27 15:30:00+00:00,21,16,5,No Signal,13078.26171875
2023-04-27 16:30:00+00:00,18,20,-2,No Signal,13108.6962890625
2023-04-27 17:30:00+00:00,14,24,-10,Short,13142.66796875
2023-04-27 18:30:00+00:00,11,30,-19,No Signal,13163.931640625
2023-04-27 19:30:00+00:00,10,33,-23,No Signal,13157.5673828125
2023-04-28 13:30:00+00:00,5,41,-36,No Signal,13213.814453125
2023-04-28 14:30:00+00:00,12,31,-19,No Signal,13137.923828125
2023-04-28 15:30:00+00:00,8,35,-27,No Signal,13179.1083984375
2023-04-28 16:30:00+00:00,7,47,-40,No Signal,13209.4326171875
2023-04-28 17:30:00+00:00,6,50,-44,No Signal,13201.052734375
2023-04-28 18:30:00+00:00,4,56,-52,No Signal,13210.8125
2023-04-28 19:30:00+00:00,2,59,-57,No Signal,13245.650390625
2023-05-01 13:30:00+00:00,5,49,-44,No Signal,13213.7353515625
2023-05-01 14:30:00+00:00,5,47,-42,No Signal,13195.7529296875
2023-05-01 15:30:00+00:00,7,44,-37,No Signal,13246.2392578125
2023-05-01 16:30:00+00:00,9,44,-35,No Signal,13267.3828125
2023-05-01 17:30:00+00:00,10,35,-25,No Signal,13250.99609375
2023-05-01 18:30:00+00:00,9,26,-17,No Signal,13231.9619140625
2023-05-01 19:30:00+00:00,7,30,-23,No Signal,13230.3251953125
2023-05-02 13:30:00+00:00,19,8,11,Long,13138.1484375
2023-05-02 14:30:00+00:00,20,8,12,No Signal,13063.611328125
2023-05-02 15:30:00+00:00,23,6,17,No Signal,13083.4853515625
2023-05-02 16:30:00+00:00,25,6,19,No Signal,13117.7421875
2023-05-02 17:30:00+00:00,25,5,20,No Signal,13107.3388671875
2023-05-02 18:30:00+00:00,22,8,14,No Signal,13130.162109375
2023-05-02 19:30:00+00:00,31,6,25,No Signal,13111.810546875
2023-05-03 13:30:00+00:00,19,8,11,No Signal,13125.421875
2023-05-03 14:30:00+00:00,15,6,9,No Signal,13116.93359375
2023-05-03 15:30:00+00:00,19,5,14,No Signal,13141.857421875
2023-05-03 16:30:00+00:00,17,5,12,No Signal,13157.8359375
2023-05-03 17:30:00+00:00,11,7,4,No Signal,13194.2353515625
2023-05-03 18:30:00+00:00,17,5,12,No Signal,13060.18359375
2023-05-03 19:30:00+00:00,22,5,17,No Signal,13034.76953125
2023-05-04 13:30:00+00:00,15,5,10,No Signal,12947.1015625
2023-05-04 14:30:00+00:00,8,11,-3,No Signal,13005.212890625
2023-05-04 15:30:00+00:00,7,9,-2,No Signal,13008.529296875
2023-05-04 16:30:00+00:00,9,7,2,No Signal,13041.7861328125
2023-05-04 17:30:00+00:00,7,7,0,No Signal,12998.51953125
2023-05-04 18:30:00+00:00,12,7,5,No Signal,12997.4189453125
2023-05-04 19:30:00+00:00,11,4,7,No Signal,12978.2646484375
2023-05-05 13:30:00+00:00,9,12,-3,No Signal,13167.984375
2023-05-05 14:30:00+00:00,7,11,-4,No Signal,13205.375
2023-05-05 15:30:00+00:00,7,13,-6,No Signal,13182.8828125
2023-05-05 16:30:00+00:00,7,11,-4,No Signal,13220.37109375
2023-05-05 17:30:00+00:00,9,10,-1,No Signal,13254.6318359375
2023-05-05 18:30:00+00:00,3,29,-26,Short,13274.72265625
2023-05-05 19:30:00+00:00,3,32,-29,No Signal,13256.8310546875
2023-05-08 13:30:00+00:00,4,33,-29,No Signal,13211.32421875
2023-05-08 14:30:00+00:00,5,32,-27,No Signal,13227.2802734375
2023-05-08 15:30:00+00:00,5,33,-28,No Signal,13253.3525390625
2023-05-08 16:30:00+00:00,5,30,-25,No Signal,13276.328125
2023-05-08 17:30:00+00:00,5,37,-32,No Signal,13276.408203125
2023-05-08 18:30:00+00:00,5,37,-32,No Signal,13280.900390625
2023-05-08 19:30:00+00:00,3,42,-39,No Signal,13288.9453125
2023-05-09 13:30:00+00:00,8,17,-9,No Signal,13221.587890625
2023-05-09 14:30:00+00:00,8,16,-8,No Signal,13214.0078125
2023-05-09 15:30:00+00:00,9,14,-5,No Signal,13201.125
2023-05-09 16:30:00+00:00,13,16,-3,No Signal,13219.4970703125
2023-05-09 17:30:00+00:00,11,10,1,No Signal,13223.4970703125
2023-05-09 18:30:00+00:00,23,8,15,Long,13201.0166015625
2023-05-09 19:30:00+00:00,18,11,7,No Signal,13200.4541015625
2023-05-10 13:30:00+00:00,4,18,-14,Short,13336.0908203125
2023-05-10 14:30:00+00:00,6,17,-11,No Signal,13304.998046875
2023-05-10 15:30:00+00:00,7,12,-5,No Signal,13296.314453125
2023-05-10 16:30:00+00:00,15,7,8,No Signal,13215.5703125
2023-05-10 17:30:00+00:00,6,11,-5,No Signal,13288.5224609375
2023-05-10 18:30:00+00:00,3,13,-10,No Signal,13369.78125
2023-05-10 19:30:00+00:00,5,12,-7,No Signal,13346.7275390625
2023-05-11 13:30:00+00:00,5,9,-4,No Signal,13346.4462890625
2023-05-11 14:30:00+00:00,7,9,-2,No Signal,13376.5146484375
2023-05-11 15:30:00+00:00,7,9,-2,No Signal,13383.40625
2023-05-11 16:30:00+00:00,7,8,-1,No Signal,13374.7314453125
2023-05-11 17:30:00+00:00,7,11,-4,No Signal,13379.7060546875
2023-05-11 18:30:00+00:00,5,10,-5,No Signal,13399.1025390625
2023-05-11 19:30:00+00:00,4,12,-8,No Signal,13387.2451171875
2023-05-12 13:30:00+00:00,11,6,5,No Signal,13350.2705078125
2023-05-12 14:30:00+00:00,10,4,6,No Signal,13321.3994140625
2023-05-12 15:30:00+00:00,16,7,9,No Signal,13297.322265625
2023-05-12 16:30:00+00:00,9,10,-1,No Signal,13297.2421875
2023-05-12 17:30:00+00:00,15,5,10,Long,13270.587890625
2023-05-12 18:30:00+00:00,24,4,20,No Signal,13301.53515625
2023-05-12 19:30:00+00:00,11,7,4,No Signal,13338.5244140625
2023-05-15 13:30:00+00:00,7,6,1,No Signal,13310.4677734375
2023-05-15 14:30:00+00:00,6,17,-11,Short,13373.1162109375
2023-05-15 15:30:00+00:00,5,19,-14,No Signal,13380.34375
2023-05-15 16:30:00+00:00,2,28,-26,No Signal,13396.1162109375
2023-05-15 17:30:00+00:00,3,25,-22,No Signal,13395.2509765625
2023-05-15 18:30:00+00:00,4,24,-20,No Signal,13404.4501953125
2023-05-15 19:30:00+00:00,6,26,-20,No Signal,13414.978515625
2023-05-16 13:30:00+00:00,12,24,-12,No Signal,13448.8251953125
2023-05-16 14:30:00+00:00,12,34,-22,No Signal,13481.4716796875
2023-05-16 15:30:00+00:00,12,30,-18,No Signal,13485.4619140625
2023-05-16 16:30:00+00:00,10,28,-18,No Signal,13473.9267578125
2023-05-16 17:30:00+00:00,10,33,-23,No Signal,13468.6611328125
2023-05-16 18:30:00+00:00,11,29,-18,No Signal,13483.46875
2023-05-16 19:30:00+00:00,18,16,2,No Signal,13426.8779296875
2023-05-17 13:30:00+00:00,20,13,7,No Signal,13458.0908203125
2023-05-17 14:30:00+00:00,20,16,4,No Signal,13478.380859375
2023-05-17 15:30:00+00:00,15,16,-1,No Signal,13494.830078125
2023-05-17 16:30:00+00:00,10,20,-10,No Signal,13584.0888671875
2023-05-17 17:30:00+00:00,10,18,-8,No Signal,13594.064453125
2023-05-17 18:30:00+00:00,12,17,-5,No Signal,13579.7119140625
2023-05-17 19:30:00+00:00,12,16,-4,No Signal,13588.318359375
2023-05-18 13:30:00+00:00,9,38,-29,No Signal,13718.98046875
2023-05-18 14:30:00+00:00,8,36,-28,No Signal,13766.8232421875
2023-05-18 15:30:00+00:00,12,29,-17,No Signal,13729.8310546875
2023-05-18 16:30:00+00:00,13,36,-23,No Signal,13746.9873046875
2023-05-18 17:30:00+00:00,11,36,-25,No Signal,13734.1728515625
2023-05-18 18:30:00+00:00,11,40,-29,No Signal,13791.18359375
2023-05-18 19:30:00+00:00,6,51,-45,No Signal,13836.04296875
2023-05-19 13:30:00+00:00,3,47,-44,No Signal,13842.5517578125
2023-05-19 14:30:00+00:00,3,37,-34,No Signal,13805.4150390625
2023-05-19 15:30:00+00:00,4,32,-28,No Signal,13795.9404296875
2023-05-19 16:30:00+00:00,4,22,-18,No Signal,13813.638671875
2023-05-19 17:30:00+00:00,4,27,-23,No Signal,13775.82421875
2023-05-19 18:30:00+00:00,5,27,-22,No Signal,13785.205078125
2023-05-19 19:30:00+00:00,4,27,-23,No Signal,13804.1025390625
2023-05-22 13:30:00+00:00,3,20,-17,No Signal,13852.71484375
2023-05-22 14:30:00+00:00,7,19,-12,No Signal,13860.6923828125
2023-05-22 15:30:00+00:00,7,24,-17,No Signal,13832.1630859375
2023-05-22 16:30:00+00:00,6,26,-20,No Signal,13852.9921875
2023-05-22 17:30:00+00:00,5,30,-25,No Signal,13867.9150390625
2023-05-22 18:30:00+00:00,12,22,-10,No Signal,13851.5595703125
2023-05-22 19:30:00+00:00,15,14,1,No Signal,13850.2421875
2023-05-23 13:30:00+00:00,26,8,18,Long,13806.12890625
2023-05-23 14:30:00+00:00,20,17,3,No Signal,13817.5439453125
2023-05-23 15:30:00+00:00,23,13,10,No Signal,13784.4169921875
2023-05-23 16:30:00+00:00,26,5,21,No Signal,13738.375
2023-05-23 17:30:00+00:00,27,6,21,No Signal,13682.41015625
2023-05-23 18:30:00+00:00,28,5,23,No Signal,13688.609375
2023-05-23 19:30:00+00:00,33,3,30,No Signal,13675.4404296875
2023-05-24 13:30:00+00:00,56,1,55,No Signal,13545.9228515625
2023-05-24 14:30:00+00:00,49,2,47,No Signal,13569.1533203125
2023-05-24 15:30:00+00:00,52,2,50,No Signal,13536.0556640625
2023-05-24 16:30:00+00:00,53,1,52,No Signal,13556.8935546875
2023-05-24 17:30:00+00:00,55,1,54,No Signal,13562.23046875
2023-05-24 18:30:00+00:00,42,1,41,No Signal,13633.2041015625
2023-05-24 19:30:00+00:00,47,3,44,No Signal,13603.6494140625
2023-05-25 13:30:00+00:00,39,4,35,No Signal,13846.46875
2023-05-25 14:30:00+00:00,38,6,32,No Signal,13923.556640625
2023-05-25 15:30:00+00:00,30,6,24,No Signal,13951.9111328125
2023-05-25 16:30:00+00:00,28,14,14,No Signal,13950.6083984375
2023-05-25 17:30:00+00:00,23,18,5,No Signal,13956.4990234375
2023-05-25 18:30:00+00:00,22,17,5,No Signal,13971.28515625
2023-05-25 19:30:00+00:00,23,16,7,No Signal,13937.1103515625
2023-05-26 13:30:00+00:00,9,46,-37,Short,14163.9619140625
2023-05-26 14:30:00+00:00,12,42,-30,No Signal,14206.58203125
2023-05-26 15:30:00+00:00,9,49,-40,No Signal,14263.2822265625
2023-05-26 16:30:00+00:00,10,46,-36,No Signal,14280.060546875
2023-05-26 17:30:00+00:00,8,44,-36,No Signal,14284.9462890625
2023-05-26 18:30:00+00:00,12,39,-27,No Signal,14306.7041015625
2023-05-26 19:30:00+00:00,10,40,-30,No Signal,14297.16796875
2023-05-30 13:30:00+00:00,7,39,-32,No Signal,14388.3564453125
2023-05-30 14:30:00+00:00,6,41,-35,No Signal,14415.0927734375
2023-05-30 15:30:00+00:00,7,38,-31,No Signal,14376.0009765625
2023-05-30 16:30:00+00:00,7,35,-28,No Signal,14350.0595703125
2023-05-30 17:30:00+00:00,7,34,-27,No Signal,14364.41015625
2023-05-30 18:30:00+00:00,9,36,-27,No Signal,14379.2255859375
2023-05-30 19:30:00+00:00,3,36,-33,No Signal,14354.8251953125
2023-05-31 13:30:00+00:00,19,8,11,Long,14261.0205078125
2023-05-31 14:30:00+00:00,19,8,11,No Signal,14232.7900390625
2023-05-31 15:30:00+00:00,17,6,11,No Signal,14229.255859375
2023-05-31 16:30:00+00:00,15,11,4,No Signal,14278.228515625
2023-05-31 17:30:00+00:00,12,11,1,No Signal,14310.65234375
2023-05-31 18:30:00+00:00,16,12,4,No Signal,14279.7412109375
2023-05-31 19:30:00+00:00,17,11,6,No Signal,14259.1533203125
2023-06-01 13:30:00+00:00,11,10,1,No Signal,14269.80859375
2023-06-01 14:30:00+00:00,9,14,-5,No Signal,14351.4443359375
2023-06-01 15:30:00+00:00,6,20,-14,Short,14419.634765625
2023-06-01 16:30:00+00:00,6,20,-14,No Signal,14419.4638671875
2023-06-01 17:30:00+00:00,4,16,-12,No Signal,14456.462890625
2023-06-01 18:30:00+00:00,4,16,-12,No Signal,14449.5966796875
2023-06-01 19:30:00+00:00,6,14,-8,No Signal,14439.5263671875
2023-06-02 13:30:00+00:00,4,43,-39,No Signal,14494.30859375
2023-06-02 14:30:00+00:00,3,48,-45,No Signal,14559.181640625
2023-06-02 15:30:00+00:00,4,45,-41,No Signal,14540.7216796875
2023-06-02 16:30:00+00:00,3,42,-39,No Signal,14569.2109375
2023-06-02 17:30:00+00:00,6,35,-29,No Signal,14543.087890625
2023-06-02 18:30:00+00:00,4,36,-32,No Signal,14546.6611328125
2023-06-02 19:30:00+00:00,3,40,-37,No Signal,14542.84765625
2023-06-05 13:30:00+00:00,0,36,-36,No Signal,14578.7080078125
2023-06-05 14:30:00+00:00,2,35,-33,No Signal,14645.02734375
2023-06-05 15:30:00+00:00,4,34,-30,No Signal,14648.8818359375
2023-06-05 16:30:00+00:00,3,28,-25,No Signal,14620.7490234375
2023-06-05 17:30:00+00:00,10,25,-15,No Signal,14585.701171875
2023-06-05 18:30:00+00:00,10,27,-17,No Signal,14562.4755859375
2023-06-05 19:30:00+00:00,8,28,-20,No Signal,14559.3935546875
2023-06-06 13:30:00+00:00,9,18,-9,No Signal,14542.1767578125
2023-06-06 14:30:00+00:00,7,13,-6,No Signal,14533.572265625
2023-06-06 15:30:00+00:00,10,16,-6,No Signal,14564.6953125
2023-06-06 16:30:00+00:00,14,10,4,No Signal,14542.80859375
2023-06-06 17:30:00+00:00,9,14,-5,No Signal,14546.328125
2023-06-06 18:30:00+00:00,11,12,-1,No Signal,14560.5654296875
2023-06-06 19:30:00+00:00,10,14,-4,No Signal,14558.47265625
2023-06-07 13:30:00+00:00,14,17,-3,No Signal,14524.5068359375
2023-06-07 14:30:00+00:00,22,12,10,Long,14462.1279296875
2023-06-07 15:30:00+00:00,34,5,29,No Signal,14363.072265625
2023-06-07 16:30:00+00:00,31,6,25,No Signal,14354.220703125
2023-06-07 17:30:00+00:00,33,7,26,No Signal,14361.38671875
2023-06-07 18:30:00+00:00,38,9,29,No Signal,14331.138671875
2023-06-07 19:30:00+00:00,39,8,31,No Signal,14304.8505859375
2023-06-08 13:30:00+00:00,26,6,20,No Signal,14394.86328125
2023-06-08 14:30:00+00:00,20,5,15,No Signal,14470.4296875
2023-06-08 15:30:00+00:00,17,6,11,No Signal,14502.6796875
2023-06-08 16:30:00+00:00,16,12,4,No Signal,14443.544921875
2023-06-08 17:30:00+00:00,15,9,6,No Signal,14448.880859375
2023-06-08 18:30:00+00:00,14,11,3,No Signal,14470.447265625
2023-06-08 19:30:00+00:00,12,9,3,No Signal,14483.439453125
2023-06-09 13:30:00+00:00,3,10,-7,No Signal,14656.7333984375
2023-06-09 14:30:00+00:00,8,6,2,No Signal,14540.9345703125
2023-06-09 15:30:00+00:00,2,10,-8,No Signal,14507.8076171875
2023-06-09 16:30:00+00:00,2,15,-13,Short,14569.2568359375
2023-06-09 17:30:00+00:00,3,17,-14,No Signal,14580.87109375
2023-06-09 18:30:00+00:00,3,17,-14,No Signal,14550.65234375
2023-06-09 19:30:00+00:00,3,18,-15,No Signal,14529.4853515625
2023-06-12 13:30:00+00:00,5,21,-16,No Signal,14612.03125
2023-06-12 14:30:00+00:00,5,13,-8,No Signal,14621.056640625
2023-06-12 15:30:00+00:00,4,12,-8,No Signal,14650.0146484375
2023-06-12 16:30:00+00:00,6,17,-11,No Signal,14659.9140625
2023-06-12 17:30:00+00:00,7,19,-12,No Signal,14692.958984375
2023-06-12 18:30:00+00:00,3,21,-18,No Signal,14756.927734375
2023-06-12 19:30:00+00:00,4,30,-26,No Signal,14785.23828125
2023-06-13 13:30:00+00:00,1,27,-26,No Signal,14799.833984375
2023-06-13 14:30:00+00:00,1,59,-58,No Signal,14895.3671875
2023-06-13 15:30:00+00:00,0,61,-61,No Signal,14873.7998046875
2023-06-13 16:30:00+00:00,0,57,-57,No Signal,14893.376953125
2023-06-13 17:30:00+00:00,1,45,-44,No Signal,14832.7158203125
2023-06-13 18:30:00+00:00,2,51,-49,No Signal,14875.4384765625
2023-06-13 19:30:00+00:00,0,56,-56,No Signal,14904.2294921875
2023-06-14 13:30:00+00:00,1,49,-48,No Signal,14951.3232421875
2023-06-14 14:30:00+00:00,1,51,-50,No Signal,15000.93359375
2023-06-14 15:30:00+00:00,1,40,-39,No Signal,14982.4775390625
2023-06-14 16:30:00+00:00,2,36,-34,No Signal,14941.62890625
2023-06-14 17:30:00+00:00,2,17,-15,No Signal,14846.533203125
2023-06-14 18:30:00+00:00,2,22,-20,No Signal,14950.9736328125
2023-06-14 19:30:00+00:00,4,20,-16,No Signal,15006.0830078125
2023-06-15 13:30:00+00:00,3,26,-23,No Signal,15075.4873046875
2023-06-15 14:30:00+00:00,1,22,-21,No Signal,15105.7197265625
2023-06-15 15:30:00+00:00,2,25,-23,No Signal,15111.7958984375
2023-06-15 16:30:00+00:00,2,25,-23,No Signal,15115.1455078125
2023-06-15 17:30:00+00:00,1,33,-32,No Signal,15164.1171875
2023-06-15 18:30:00+00:00,2,39,-37,No Signal,15218.638671875
2023-06-15 19:30:00+00:00,2,32,-30,No Signal,15186.404296875
2023-06-16 13:30:00+00:00,1,36,-35,No Signal,15225.595703125
2023-06-16 14:30:00+00:00,4,16,-12,No Signal,15160.2158203125
2023-06-16 15:30:00+00:00,1,14,-13,No Signal,15203.1103515625
2023-06-16 16:30:00+00:00,1,19,-18,No Signal,15187.2626953125
2023-06-16 17:30:00+00:00,0,39,-39,No Signal,15169.818359375
2023-06-16 18:30:00+00:00,2,20,-18,No Signal,15111.458984375
2023-06-16 19:30:00+00:00,7,19,-12,No Signal,15084.9990234375
2023-06-20 13:30:00+00:00,15,4,11,Long,14957.013671875
2023-06-20 14:30:00+00:00,18,2,16,No Signal,14994.326171875
2023-06-20 15:30:00+00:00,12,2,10,No Signal,15059.18359375
2023-06-20 16:30:00+00:00,10,4,6,No Signal,15084.3671875
2023-06-20 17:30:00+00:00,18,3,15,No Signal,15085.041015625
2023-06-20 18:30:00+00:00,32,3,29,No Signal,15069.5224609375
2023-06-20 19:30:00+00:00,28,2,26,No Signal,15074.0673828125
2023-06-21 13:30:00+00:00,48,1,47,No Signal,14919.2568359375
2023-06-21 14:30:00+00:00,47,1,46,No Signal,14865.6650390625
2023-06-21 15:30:00+00:00,46,1,45,No Signal,14890.734375
2023-06-21 16:30:00+00:00,46,1,45,No Signal,14872.8056640625
2023-06-21 17:30:00+00:00,35,3,32,No Signal,14954.134765625
2023-06-21 18:30:00+00:00,34,4,30,No Signal,14919.3984375
2023-06-21 19:30:00+00:00,34,5,29,No Signal,14865.771484375
2023-06-22 13:30:00+00:00,14,6,8,No Signal,14964.3798828125
2023-06-22 14:30:00+00:00,17,6,11,No Signal,14939.1484375
2023-06-22 15:30:00+00:00,23,5,18,No Signal,14952.8212890625
2023-06-22 16:30:00+00:00,27,3,24,No Signal,14946.1962890625
2023-06-22 17:30:00+00:00,20,5,15,No Signal,14983.3701171875
2023-06-22 18:30:00+00:00,22,5,17,No Signal,14986.994140625
2023-06-22 19:30:00+00:00,18,7,11,No Signal,15043.0029296875
2023-06-23 13:30:00+00:00,23,5,18,No Signal,14878.654296875
2023-06-23 14:30:00+00:00,22,2,20,No Signal,14849.91015625
2023-06-23 15:30:00+00:00,17,3,14,No Signal,14941.0439453125
2023-06-23 16:30:00+00:00,14,2,12,No Signal,14973.4306640625
2023-06-23 17:30:00+00:00,25,0,25,No Signal,14936.6435546875
2023-06-23 18:30:00+00:00,25,1,24,No Signal,14893.546875
2023-06-23 19:30:00+00:00,20,2,18,No Signal,14889.3798828125
2023-06-26 13:30:00+00:00,16,3,13,No Signal,14956.3212890625
2023-06-26 14:30:00+00:00,14,3,11,No Signal,14832.8232421875
2023-06-26 15:30:00+00:00,14,2,12,No Signal,14749.36328125
2023-06-26 16:30:00+00:00,13,3,10,No Signal,14757.3603515625
2023-06-26 17:30:00+00:00,20,2,18,No Signal,14744.0673828125
2023-06-26 18:30:00+00:00,20,2,18,No Signal,14755.66796875
2023-06-26 19:30:00+00:00,22,1,21,No Signal,14691.2138671875
2023-06-27 13:30:00+00:00,12,13,-1,No Signal,14767.76953125
2023-06-27 14:30:00+00:00,9,20,-11,Short,14813.2763671875
2023-06-27 15:30:00+00:00,11,19,-8,No Signal,14861.5361328125
2023-06-27 16:30:00+00:00,6,21,-15,No Signal,14905.8095703125
2023-06-27 17:30:00+00:00,5,27,-22,No Signal,14956.1123046875
2023-06-27 18:30:00+00:00,5,32,-27,No Signal,14971.7666015625
2023-06-27 19:30:00+00:00,6,29,-23,No Signal,14945.4189453125
2023-06-28 13:30:00+00:00,3,15,-12,No Signal,14975.6328125
2023-06-28 14:30:00+00:00,2,22,-20,No Signal,14978.291015625
2023-06-28 15:30:00+00:00,4,26,-22,No Signal,14981.7392578125
2023-06-28 16:30:00+00:00,6,20,-14,No Signal,14958.2216796875
2023-06-28 17:30:00+00:00,4,29,-25,No Signal,14972.44140625
2023-06-28 18:30:00+00:00,5,21,-16,No Signal,14940.619140625
2023-06-28 19:30:00+00:00,4,38,-34,No Signal,14968.41015625
2023-06-29 13:30:00+00:00,7,23,-16,No Signal,14908.017578125
2023-06-29 14:30:00+00:00,6,23,-17,No Signal,14972.2109375
2023-06-29 15:30:00+00:00,8,18,-10,No Signal,14957.83203125
2023-06-29 16:30:00+00:00,9,14,-5,No Signal,14939.833984375
2023-06-29 17:30:00+00:00,13,9,4,No Signal,14913.4482421875
2023-06-29 18:30:00+00:00,14,9,5,No Signal,14919.74609375
2023-06-29 19:30:00+00:00,14,14,0,No Signal,14940.001953125
2023-06-30 13:30:00+00:00,2,22,-20,No Signal,15193.234375
2023-06-30 14:30:00+00:00,2,27,-25,No Signal,15169.9462890625
2023-06-30 15:30:00+00:00,1,28,-27,No Signal,15168.166015625
2023-06-30 16:30:00+00:00,3,36,-33,No Signal,15185.1181640625
2023-06-30 17:30:00+00:00,2,41,-39,No Signal,15201.1875
2023-06-30 18:30:00+00:00,2,40,-38,No Signal,15197.265625
2023-06-30 19:30:00+00:00,2,32,-30,No Signal,15175.625
2023-07-03 13:30:00+00:00,2,37,-35,No Signal,15199.8427734375
2023-07-03 14:30:00+00:00,3,27,-24,No Signal,15166.2978515625
2023-07-03 15:30:00+00:00,2,32,-30,No Signal,15184.1357421875
2023-07-05 13:30:00+00:00,3,24,-21,No Signal,15254.2470703125
2023-07-05 14:30:00+00:00,2,26,-24,No Signal,15208.1650390625
2023-07-05 15:30:00+00:00,2,23,-21,No Signal,15215.2861328125
2023-07-05 16:30:00+00:00,2,21,-19,No Signal,15212.4267578125
2023-07-05 17:30:00+00:00,12,7,5,No Signal,15189.587890625
2023-07-05 18:30:00+00:00,9,12,-3,No Signal,15229.701171875
2023-07-05 19:30:00+00:00,11,11,0,No Signal,15202.748046875
2023-07-06 13:30:00+00:00,39,2,37,Long,15020.1923828125
2023-07-06 14:30:00+00:00,42,3,39,No Signal,14993.5859375
2023-07-06 15:30:00+00:00,30,2,28,No Signal,15057.9658203125
2023-07-06 16:30:00+00:00,24,2,22,No Signal,15066.0849609375
2023-07-06 17:30:00+00:00,26,2,24,No Signal,15072.7421875
2023-07-06 18:30:00+00:00,20,2,18,No Signal,15090.9130859375
2023-07-06 19:30:00+00:00,27,2,25,No Signal,15089.123046875
2023-07-07 13:30:00+00:00,21,2,19,No Signal,15081.9853515625
2023-07-07 14:30:00+00:00,17,0,17,No Signal,15105.8115234375
2023-07-07 15:30:00+00:00,14,1,13,No Signal,15151.310546875
2023-07-07 16:30:00+00:00,8,3,5,No Signal,15208.7607421875
2023-07-07 17:30:00+00:00,11,3,8,No Signal,15180.7451171875
2023-07-07 18:30:00+00:00,16,1,15,No Signal,15107.197265625
2023-07-07 19:30:00+00:00,22,1,21,No Signal,15035.5595703125
2023-07-10 13:30:00+00:00,3,31,-28,Short,15034.44140625
2023-07-10 14:30:00+00:00,5,44,-39,No Signal,15011.9169921875
2023-07-10 15:30:00+00:00,10,39,-29,No Signal,14964.9853515625
2023-07-10 16:30:00+00:00,10,38,-28,No Signal,15022.0849609375
2023-07-10 17:30:00+00:00,9,37,-28,No Signal,15044.5576171875
2023-07-10 18:30:00+00:00,10,36,-26,No Signal,15027.3642578125
2023-07-10 19:30:00+00:00,8,35,-27,No Signal,15046.31640625
2023-07-11 13:30:00+00:00,6,28,-22,No Signal,15032.8193359375
2023-07-11 14:30:00+00:00,6,30,-24,No Signal,15041.14453125
2023-07-11 15:30:00+00:00,9,28,-19,No Signal,15052.1123046875
2023-07-11 16:30:00+00:00,9,24,-15,No Signal,15057.677734375
2023-07-11 17:30:00+00:00,9,23,-14,No Signal,15037.87890625
2023-07-11 18:30:00+00:00,6,38,-32,No Signal,15077.2841796875
2023-07-11 19:30:00+00:00,4,50,-46,No Signal,15118.7587890625
2023-07-12 13:30:00+00:00,1,53,-52,No Signal,15344.921875
2023-07-12 14:30:00+00:00,3,44,-41,No Signal,15308.0205078125
2023-07-12 15:30:00+00:00,3,28,-25,No Signal,15249.341796875
2023-07-12 16:30:00+00:00,2,30,-28,No Signal,15299.48828125
2023-07-12 17:30:00+00:00,2,33,-31,No Signal,15332.6357421875
2023-07-12 18:30:00+00:00,2,30,-28,No Signal,15300.44140625
2023-07-12 19:30:00+00:00,4,32,-28,No Signal,15309.7939453125
2023-07-13 13:30:00+00:00,2,50,-48,No Signal,15428.0419921875
2023-07-13 14:30:00+00:00,3,49,-46,No Signal,15462.8994140625
2023-07-13 15:30:00+00:00,3,54,-51,No Signal,15508.333984375
2023-07-13 16:30:00+00:00,2,51,-49,No Signal,15523.365234375
2023-07-13 17:30:00+00:00,2,55,-53,No Signal,15531.5927734375
2023-07-13 18:30:00+00:00,2,55,-53,No Signal,15581.009765625
2023-07-13 19:30:00+00:00,2,51,-49,No Signal,15572.037109375
2023-07-14 13:30:00+00:00,9,30,-21,No Signal,15684.44921875
2023-07-14 14:30:00+00:00,6,31,-25,No Signal,15670.7880859375
2023-07-14 15:30:00+00:00,4,42,-38,No Signal,15639.87109375
2023-07-14 16:30:00+00:00,6,37,-31,No Signal,15617.802734375
2023-07-14 17:30:00+00:00,6,30,-24,No Signal,15582.498046875
2023-07-14 18:30:00+00:00,4,31,-27,No Signal,15539.1962890625
2023-07-14 19:30:00+00:00,4,31,-27,No Signal,15565.3984375
2023-07-17 13:30:00+00:00,3,26,-23,No Signal,15620.078125
2023-07-17 14:30:00+00:00,7,25,-18,No Signal,15646.59765625
2023-07-17 15:30:00+00:00,5,26,-21,No Signal,15639.9482421875
2023-07-17 16:30:00+00:00,3,26,-23,No Signal,15655.4697265625
2023-07-17 17:30:00+00:00,1,28,-27,No Signal,15696.42578125
2023-07-17 18:30:00+00:00,4,34,-30,No Signal,15733.939453125
2023-07-17 19:30:00+00:00,5,27,-22,No Signal,15709.833984375
2023-07-18 13:30:00+00:00,6,24,-18,No Signal,15638.6298828125
2023-07-18 14:30:00+00:00,11,23,-12,No Signal,15653.951171875
2023-07-18 15:30:00+00:00,10,16,-6,No Signal,15776.1103515625
2023-07-18 16:30:00+00:00,12,17,-5,No Signal,15805.3369140625
2023-07-18 17:30:00+00:00,8,22,-14,No Signal,15864.9541015625
2023-07-18 18:30:00+00:00,7,33,-26,No Signal,15877.0634765625
2023-07-18 19:30:00+00:00,6,29,-23,No Signal,15842.07421875
2023-07-19 13:30:00+00:00,4,26,-22,No Signal,15858.8681640625
2023-07-19 14:30:00+00:00,3,19,-16,No Signal,15902.384765625
2023-07-19 15:30:00+00:00,4,14,-10,No Signal,15849.95703125
2023-07-19 16:30:00+00:00,8,8,0,No Signal,15813.2548828125
2023-07-19 17:30:00+00:00,12,8,4,No Signal,15793.5927734375
2023-07-19 18:30:00+00:00,8,7,1,No Signal,15852.830078125
2023-07-19 19:30:00+00:00,10,8,2,No Signal,15825.89453125
2023-07-20 13:30:00+00:00,11,3,8,No Signal,15627.0947265625
2023-07-20 14:30:00+00:00,10,3,7,No Signal,15623.3603515625
2023-07-20 15:30:00+00:00,13,19,-6,No Signal,15593.90625
2023-07-20 16:30:00+00:00,13,19,-6,No Signal,15586.5615234375
2023-07-20 17:30:00+00:00,26,14,12,Long,15497.125
2023-07-20 18:30:00+00:00,29,14,15,No Signal,15435.3291015625
2023-07-20 19:30:00+00:00,30,10,20,No Signal,15469.7666015625
2023-07-21 13:30:00+00:00,34,12,22,No Signal,15435.908203125
2023-07-21 14:30:00+00:00,26,12,14,No Signal,15515.62109375
2023-07-21 15:30:00+00:00,19,14,5,No Signal,15459.9140625
2023-07-21 16:30:00+00:00,12,12,0,No Signal,15508.6279296875
2023-07-21 17:30:00+00:00,13,13,0,No Signal,15481.1162109375
2023-07-21 18:30:00+00:00,27,15,12,No Signal,15434.32421875
2023-07-21 19:30:00+00:00,22,13,9,No Signal,15426.35546875
2023-07-24 13:30:00+00:00,10,3,7,No Signal,15468.11328125
2023-07-24 14:30:00+00:00,8,5,3,No Signal,15444.6591796875
2023-07-24 15:30:00+00:00,8,7,1,No Signal,15443.396484375
2023-07-24 16:30:00+00:00,8,5,3,No Signal,15442.646484375
2023-07-24 17:30:00+00:00,6,14,-8,No Signal,15465.951171875
2023-07-24 18:30:00+00:00,4,12,-8,No Signal,15416.0048828125
2023-07-24 19:30:00+00:00,3,14,-11,Short,15449.0966796875
2023-07-25 13:30:00+00:00,11,18,-7,No Signal,15521.5390625
2023-07-25 14:30:00+00:00,10,16,-6,No Signal,15537.8896484375
2023-07-25 15:30:00+00:00,8,16,-8,No Signal,15556.353515625
2023-07-25 16:30:00+00:00,9,15,-6,No Signal,15593.2548828125
2023-07-25 17:30:00+00:00,5,18,-13,No Signal,15598.8115234375
2023-07-25 18:30:00+00:00,4,19,-15,No Signal,15591.5537109375
2023-07-25 19:30:00+00:00,4,18,-14,No Signal,15564.3173828125
2023-07-26 13:30:00+00:00,8,19,-11,No Signal,15498.4619140625
2023-07-26 14:30:00+00:00,10,12,-2,No Signal,15443.939453125
2023-07-26 15:30:00+00:00,10,14,-4,No Signal,15450.9775390625
2023-07-26 16:30:00+00:00,8,16,-8,No Signal,15451.3388671875
2023-07-26 17:30:00+00:00,10,12,-2,No Signal,15452.1767578125
2023-07-26 18:30:00+00:00,8,16,-8,No Signal,15466.232421875
2023-07-26 19:30:00+00:00,7,17,-10,No Signal,15501.3955078125
2023-07-27 13:30:00+00:00,10,18,-8,No Signal,15668.146484375
2023-07-27 14:30:00+00:00,13,20,-7,No Signal,15717.9482421875
2023-07-27 15:30:00+00:00,12,21,-9,No Signal,15744.36328125
2023-07-27 16:30:00+00:00,17,14,3,No Signal,15639.8388671875
2023-07-27 17:30:00+00:00,28,8,20,Long,15516.9189453125
2023-07-27 18:30:00+00:00,31,8,23,No Signal,15472.0966796875
2023-07-27 19:30:00+00:00,31,9,22,No Signal,15466.302734375
2023-07-28 13:30:00+00:00,10,15,-5,No Signal,15691.7255859375
2023-07-28 14:30:00+00:00,11,21,-10,Short,15757.5419921875
2023-07-28 15:30:00+00:00,11,19,-8,No Signal,15785.0947265625
2023-07-28 16:30:00+00:00,10,17,-7,No Signal,15725.3349609375
2023-07-28 17:30:00+00:00,10,18,-8,No Signal,15752.3037109375
2023-07-28 18:30:00+00:00,10,17,-7,No Signal,15743.0107421875
2023-07-28 19:30:00+00:00,11,17,-6,No Signal,15745.970703125
2023-07-31 13:30:00+00:00,15,14,1,No Signal,15759.5947265625
2023-07-31 14:30:00+00:00,13,10,3,No Signal,15753.8427734375
2023-07-31 15:30:00+00:00,14,8,6,No Signal,15758.4873046875
2023-07-31 16:30:00+00:00,11,13,-2,No Signal,15730.46484375
2023-07-31 17:30:00+00:00,4,30,-26,No Signal,15731.9677734375
2023-07-31 18:30:00+00:00,4,37,-33,No Signal,15730.8193359375
2023-07-31 19:30:00+00:00,3,40,-37,No Signal,15759.0380859375
2023-08-01 13:30:00+00:00,15,15,0,No Signal,15683.6689453125
2023-08-01 14:30:00+00:00,18,14,4,No Signal,15724.8671875
2023-08-01 15:30:00+00:00,16,8,8,No Signal,15699.4912109375
2023-08-01 16:30:00+00:00,15,12,3,No Signal,15720.9306640625
2023-08-01 17:30:00+00:00,17,13,4,No Signal,15733.2861328125
2023-08-01 18:30:00+00:00,15,13,2,No Signal,15735.5263671875
2023-08-01 19:30:00+00:00,17,13,4,No Signal,15718.5
2023-08-02 13:30:00+00:00,40,4,36,Long,15456.9921875
2023-08-02 14:30:00+00:00,48,7,41,No Signal,15412.8095703125
2023-08-02 15:30:00+00:00,51,8,43,No Signal,15335.5947265625
2023-08-02 16:30:00+00:00,42,8,34,No Signal,15398.64453125
2023-08-02 17:30:00+00:00,38,3,35,No Signal,15405.736328125
2023-08-02 18:30:00+00:00,47,3,44,No Signal,15342.8359375
2023-08-02 19:30:00+00:00,47,3,44,No Signal,15374.228515625
2023-08-03 13:30:00+00:00,45,5,40,No Signal,15273.822265625
2023-08-03 14:30:00+00:00,34,4,30,No Signal,15378.3515625
2023-08-03 15:30:00+00:00,27,7,20,No Signal,15387.841796875
2023-08-03 16:30:00+00:00,31,5,26,No Signal,15408.2626953125
2023-08-03 17:30:00+00:00,33,4,29,No Signal,15382.5126953125
2023-08-03 18:30:00+00:00,42,3,39,No Signal,15357.236328125
2023-08-03 19:30:00+00:00,37,3,34,No Signal,15351.6611328125
2023-08-04 13:30:00+00:00,16,10,6,No Signal,15383.015625
2023-08-04 14:30:00+00:00,19,13,6,No Signal,15457.693359375
2023-08-04 15:30:00+00:00,14,25,-11,Short,15505.08203125
2023-08-04 16:30:00+00:00,17,15,2,No Signal,15466.63671875
2023-08-04 17:30:00+00:00,22,7,15,Long,15346.681640625
2023-08-04 18:30:00+00:00,19,7,12,No Signal,15294.63671875
2023-08-04 19:30:00+00:00,24,8,16,No Signal,15275.5625
2023-08-07 13:30:00+00:00,10,13,-3,No Signal,15343.9619140625
2023-08-07 14:30:00+00:00,19,7,12,No Signal,15280.2880859375
2023-08-07 15:30:00+00:00,17,7,10,No Signal,15339.599609375
2023-08-07 16:30:00+00:00,17,6,11,No Signal,15342.77734375
2023-08-07 17:30:00+00:00,18,6,12,No Signal,15346.1943359375
2023-08-07 18:30:00+00:00,13,5,8,No Signal,15363.82421875
2023-08-07 19:30:00+00:00,9,7,2,No Signal,15408.625
2023-08-08 13:30:00+00:00,20,4,16,No Signal,15212.3466796875
2023-08-08 14:30:00+00:00,28,2,26,No Signal,15187.5322265625
2023-08-08 15:30:00+00:00,35,1,34,No Signal,15191.9091796875
2023-08-08 16:30:00+00:00,29,2,27,No Signal,15209.8359375
2023-08-08 17:30:00+00:00,17,4,13,No Signal,15235.7177734375
2023-08-08 18:30:00+00:00,10,9,1,No Signal,15258.4599609375
2023-08-08 19:30:00+00:00,11,11,0,No Signal,15273.75390625
2023-08-09 13:30:00+00:00,16,5,11,No Signal,15207.5546875
2023-08-09 14:30:00+00:00,17,9,8,No Signal,15095.28125
2023-08-09 15:30:00+00:00,21,6,15,No Signal,15125.857421875
2023-08-09 16:30:00+00:00,14,7,7,No Signal,15170.9208984375
2023-08-09 17:30:00+00:00,10,8,2,No Signal,15215.7734375
2023-08-09 18:30:00+00:00,13,8,5,No Signal,15174.716796875
2023-08-09 19:30:00+00:00,34,5,29,No Signal,15105.6416015625
2023-08-10 13:30:00+00:00,2,36,-34,Short,15324.8046875
2023-08-10 14:30:00+00:00,4,14,-10,No Signal,15224.3642578125
2023-08-10 15:30:00+00:00,4,6,-2,No Signal,15160.4189453125
2023-08-10 16:30:00+00:00,4,3,1,No Signal,15131.8349609375
2023-08-10 17:30:00+00:00,5,1,4,No Signal,15140.5029296875
2023-08-10 18:30:00+00:00,7,2,5,No Signal,15135.1923828125
2023-08-10 19:30:00+00:00,6,1,5,No Signal,15129.794921875
2023-08-11 13:30:00+00:00,11,3,8,No Signal,15076.890625
2023-08-11 14:30:00+00:00,12,2,10,Long,14990.5458984375
2023-08-11 15:30:00+00:00,11,2,9,No Signal,15014.6953125
2023-08-11 16:30:00+00:00,12,1,11,No Signal,15033.2060546875
2023-08-11 17:30:00+00:00,16,1,15,No Signal,15043.8388671875
2023-08-11 18:30:00+00:00,14,2,12,No Signal,15048.96875
2023-08-11 19:30:00+00:00,13,5,8,No Signal,15029.9453125
2023-08-14 13:30:00+00:00,37,2,35,No Signal,15078.3291015625
2023-08-14 14:30:00+00:00,20,2,18,No Signal,15151.0908203125
2023-08-14 15:30:00+00:00,15,8,7,No Signal,15123.6943359375
2023-08-14 16:30:00+00:00,10,9,1,No Signal,15162.111328125
2023-08-14 17:30:00+00:00,13,11,2,No Signal,15146.7861328125
2023-08-14 18:30:00+00:00,12,9,3,No Signal,15157.40234375
2023-08-14 19:30:00+00:00,6,15,-9,No Signal,15205.8916015625
2023-08-15 13:30:00+00:00,11,5,6,No Signal,15071.193359375
2023-08-15 14:30:00+00:00,6,14,-8,No Signal,15109.3193359375
2023-08-15 15:30:00+00:00,9,13,-4,No Signal,15117.822265625
2023-08-15 16:30:00+00:00,13,10,3,No Signal,15113.61328125
2023-08-15 17:30:00+00:00,15,12,3,No Signal,15082.435546875
2023-08-15 18:30:00+00:00,21,6,15,No Signal,15025.9365234375
2023-08-15 19:30:00+00:00,16,6,10,No Signal,15041.0244140625
2023-08-16 13:30:00+00:00,14,6,8,No Signal,15039.2880859375
2023-08-16 14:30:00+00:00,19,4,15,No Signal,15032.1416015625
2023-08-16 15:30:00+00:00,29,2,27,No Signal,14947.638671875
2023-08-16 16:30:00+00:00,33,1,32,No Signal,14950.416015625
2023-08-16 17:30:00+00:00,21,1,20,No Signal,15003.3173828125
2023-08-16 18:30:00+00:00,38,1,37,No Signal,14901.6572265625
2023-08-16 19:30:00+00:00,54,0,54,No Signal,14876.7119140625
2023-08-17 13:30:00+00:00,34,3,31,No Signal,14828.892578125
2023-08-17 14:30:00+00:00,46,1,45,No Signal,14812.0810546875
2023-08-17 15:30:00+00:00,29,4,25,No Signal,14878.9013671875
2023-08-17 16:30:00+00:00,36,2,34,No Signal,14848.056640625
2023-08-17 17:30:00+00:00,35,1,34,No Signal,14801.2587890625
2023-08-17 18:30:00+00:00,37,3,34,No Signal,14736.5673828125
2023-08-17 19:30:00+00:00,42,3,39,No Signal,14714.16015625
2023-08-18 13:30:00+00:00,58,1,57,No Signal,14585.076171875
2023-08-18 14:30:00+00:00,56,1,55,No Signal,14619.705078125
2023-08-18 15:30:00+00:00,42,1,41,No Signal,14654.8466796875
2023-08-18 16:30:00+00:00,42,2,40,No Signal,14650.7802734375
2023-08-18 17:30:00+00:00,44,1,43,No Signal,14683.04296875
2023-08-18 18:30:00+00:00,30,4,26,No Signal,14698.5908203125
2023-08-18 19:30:00+00:00,28,4,24,No Signal,14695.111328125
2023-08-21 13:30:00+00:00,26,8,18,No Signal,14779.58984375
2023-08-21 14:30:00+00:00,24,11,13,No Signal,14759.7099609375
2023-08-21 15:30:00+00:00,26,11,15,No Signal,14821.28125
2023-08-21 16:30:00+00:00,16,12,4,No Signal,14879.056640625
2023-08-21 17:30:00+00:00,14,17,-3,No Signal,14903.25
2023-08-21 18:30:00+00:00,7,26,-19,Short,14936.6064453125
2023-08-21 19:30:00+00:00,6,29,-23,No Signal,14936.7783203125
2023-08-22 13:30:00+00:00,4,40,-36,No Signal,14958.244140625
2023-08-22 14:30:00+00:00,4,40,-36,No Signal,14968.58203125
2023-08-22 15:30:00+00:00,4,21,-17,No Signal,14911.619140625
2023-08-22 16:30:00+00:00,4,22,-18,No Signal,14908.5625
2023-08-22 17:30:00+00:00,5,20,-15,No Signal,14927.091796875
2023-08-22 18:30:00+00:00,4,21,-17,No Signal,14917.876953125
2023-08-22 19:30:00+00:00,7,20,-13,No Signal,14909.833984375
2023-08-23 13:30:00+00:00,6,38,-32,No Signal,15076.6181640625
2023-08-23 14:30:00+00:00,3,49,-46,No Signal,15140.0869140625
2023-08-23 15:30:00+00:00,3,42,-39,No Signal,15124.29296875
2023-08-23 16:30:00+00:00,4,41,-37,No Signal,15168.5517578125
2023-08-23 17:30:00+00:00,4,39,-35,No Signal,15159.37890625
2023-08-23 18:30:00+00:00,3,36,-33,No Signal,15177.9677734375
2023-08-23 19:30:00+00:00,4,30,-26,No Signal,15147.7685546875
2023-08-24 13:30:00+00:00,3,17,-14,No Signal,15032.4404296875
2023-08-24 14:30:00+00:00,6,7,-1,No Signal,14972.2265625
2023-08-24 15:30:00+00:00,5,8,-3,No Signal,14951.5703125
2023-08-24 16:30:00+00:00,7,6,1,No Signal,14927.5029296875
2023-08-24 17:30:00+00:00,9,6,3,No Signal,14927.7216796875
2023-08-24 18:30:00+00:00,13,7,6,No Signal,14877.712890625
2023-08-24 19:30:00+00:00,13,4,9,No Signal,14815.9375
2023-08-25 13:30:00+00:00,29,1,28,Long,14852.203125
2023-08-25 14:30:00+00:00,39,1,38,No Signal,14818.587890625
2023-08-25 15:30:00+00:00,37,2,35,No Signal,14837.8564453125
2023-08-25 16:30:00+00:00,41,3,38,No Signal,14826.3076171875
2023-08-25 17:30:00+00:00,26,3,23,No Signal,14931.154296875
2023-08-25 18:30:00+00:00,17,2,15,No Signal,14972.4912109375
2023-08-25 19:30:00+00:00,17,3,14,No Signal,14939.5888671875
2023-08-28 13:30:00+00:00,2,8,-6,No Signal,15049.8623046875
2023-08-28 14:30:00+00:00,1,11,-10,Short,14977.6083984375
2023-08-28 15:30:00+00:00,3,8,-5,No Signal,14967.203125
2023-08-28 16:30:00+00:00,1,15,-14,No Signal,15044.1767578125
2023-08-28 17:30:00+00:00,1,9,-8,No Signal,14985.330078125
2023-08-28 18:30:00+00:00,0,13,-13,No Signal,15009.7158203125
2023-08-28 19:30:00+00:00,0,35,-35,No Signal,15054.447265625
2023-08-29 13:30:00+00:00,0,49,-49,No Signal,15252.0
2023-08-29 14:30:00+00:00,0,58,-58,No Signal,15304.72265625
2023-08-29 15:30:00+00:00,0,63,-63,No Signal,15345.3642578125
2023-08-29 16:30:00+00:00,0,66,-66,No Signal,15338.5546875
2023-08-29 17:30:00+00:00,1,51,-50,No Signal,15356.3056640625
2023-08-29 18:30:00+00:00,0,53,-53,No Signal,15388.5224609375
2023-08-29 19:30:00+00:00,0,59,-59,No Signal,15380.140625
2023-08-30 13:30:00+00:00,2,29,-27,No Signal,15369.806640625
2023-08-30 14:30:00+00:00,1,56,-55,No Signal,15427.3779296875
2023-08-30 15:30:00+00:00,1,61,-60,No Signal,15472.3056640625
2023-08-30 16:30:00+00:00,1,49,-48,No Signal,15461.0830078125
2023-08-30 17:30:00+00:00,1,54,-53,No Signal,15421.51953125
2023-08-30 18:30:00+00:00,1,54,-53,No Signal,15457.9296875
2023-08-30 19:30:00+00:00,2,50,-48,No Signal,15462.93359375
2023-08-31 13:30:00+00:00,1,38,-37,No Signal,15559.6669921875
2023-08-31 14:30:00+00:00,2,32,-30,No Signal,15536.4521484375
2023-08-31 15:30:00+00:00,4,24,-20,No Signal,15503.0380859375
2023-08-31 16:30:00+00:00,3,30,-27,No Signal,15538.2880859375
2023-08-31 17:30:00+00:00,4,30,-26,No Signal,15553.353515625
2023-08-31 18:30:00+00:00,11,23,-12,No Signal,15539.146484375
2023-08-31 19:30:00+00:00,13,17,-4,No Signal,15505.5146484375
2023-09-01 13:30:00+00:00,9,31,-22,No Signal,15550.841796875
2023-09-01 14:30:00+00:00,11,22,-11,No Signal,15478.3232421875
2023-09-01 15:30:00+00:00,14,17,-3,No Signal,15470.2822265625
2023-09-01 16:30:00+00:00,13,17,-4,No Signal,15461.8349609375
2023-09-01 17:30:00+00:00,12,17,-5,No Signal,15442.8544921875
2023-09-01 18:30:00+00:00,13,17,-4,No Signal,15482.3369140625
2023-09-01 19:30:00+00:00,9,19,-10,No Signal,15488.8984375
2023-09-05 13:30:00+00:00,16,8,8,No Signal,15464.609375
2023-09-05 14:30:00+00:00,13,11,2,No Signal,15508.150390625
2023-09-05 15:30:00+00:00,14,14,0,No Signal,15515.16015625
2023-09-05 16:30:00+00:00,16,11,5,No Signal,15502.8701171875
2023-09-05 17:30:00+00:00,13,13,0,No Signal,15550.3251953125
2023-09-05 18:30:00+00:00,12,11,1,No Signal,15522.76953125
2023-09-05 19:30:00+00:00,13,14,-1,No Signal,15506.0908203125
2023-09-06 13:30:00+00:00,29,3,26,Long,15366.0537109375
2023-09-06 14:30:00+00:00,22,4,18,No Signal,15366.337890625
2023-09-06 15:30:00+00:00,22,4,18,No Signal,15316.142578125
2023-09-06 16:30:00+00:00,23,4,19,No Signal,15326.462890625
2023-09-06 17:30:00+00:00,20,5,15,No Signal,15346.6259765625
2023-09-06 18:30:00+00:00,24,3,21,No Signal,15334.7646484375
2023-09-06 19:30:00+00:00,21,5,16,No Signal,15373.880859375
2023-09-07 13:30:00+00:00,31,2,29,No Signal,15195.337890625
2023-09-07 14:30:00+00:00,36,6,30,No Signal,15214.4775390625
2023-09-07 15:30:00+00:00,24,10,14,No Signal,15247.0234375
2023-09-07 16:30:00+00:00,21,10,11,No Signal,15251.701171875
2023-09-07 17:30:00+00:00,28,8,20,No Signal,15240.53125
2023-09-07 18:30:00+00:00,21,8,13,No Signal,15267.9697265625
2023-09-07 19:30:00+00:00,22,6,16,No Signal,15260.857421875
2023-09-08 13:30:00+00:00,14,15,-1,No Signal,15360.8232421875
2023-09-08 14:30:00+00:00,14,14,0,No Signal,15341.986328125
2023-09-08 15:30:00+00:00,17,16,1,No Signal,15326.763671875
2023-09-08 16:30:00+00:00,17,16,1,No Signal,15305.376953125
2023-09-08 17:30:00+00:00,22,11,11,No Signal,15280.62890625
2023-09-08 18:30:00+00:00,22,7,15,No Signal,15249.1435546875
2023-09-08 19:30:00+00:00,21,8,13,No Signal,15281.8935546875
2023-09-11 13:30:00+00:00,4,26,-22,Short,15365.47265625
2023-09-11 14:30:00+00:00,7,21,-14,No Signal,15385.25390625
2023-09-11 15:30:00+00:00,16,17,-1,No Signal,15385.2216796875
2023-09-11 16:30:00+00:00,14,19,-5,No Signal,15422.0947265625
2023-09-11 17:30:00+00:00,5,24,-19,No Signal,15464.21875
2023-09-11 18:30:00+00:00,7,25,-18,No Signal,15477.22265625
2023-09-11 19:30:00+00:00,4,22,-18,No Signal,15463.2314453125
2023-09-12 13:30:00+00:00,14,15,-1,No Signal,15377.1083984375
2023-09-12 14:30:00+00:00,19,15,4,No Signal,15337.201171875
2023-09-12 15:30:00+00:00,12,15,-3,No Signal,15358.1279296875
2023-09-12 16:30:00+00:00,4,18,-14,No Signal,15392.916015625
2023-09-12 17:30:00+00:00,5,20,-15,No Signal,15332.7314453125
2023-09-12 18:30:00+00:00,8,14,-6,No Signal,15285.935546875
2023-09-12 19:30:00+00:00,9,10,-1,No Signal,15292.599609375
2023-09-13 13:30:00+00:00,16,6,10,Long,15322.0107421875
2023-09-13 14:30:00+00:00,13,9,4,No Signal,15389.8486328125
2023-09-13 15:30:00+00:00,9,6,3,No Signal,15385.8994140625
2023-09-13 16:30:00+00:00,10,4,6,No Signal,15396.2568359375
2023-09-13 17:30:00+00:00,19,6,13,No Signal,15388.244140625
2023-09-13 18:30:00+00:00,22,4,18,No Signal,15337.0947265625
2023-09-13 19:30:00+00:00,20,4,16,No Signal,15347.4833984375
2023-09-14 13:30:00+00:00,14,8,6,No Signal,15380.8271484375
2023-09-14 14:30:00+00:00,5,18,-13,Short,15462.65625
2023-09-14 15:30:00+00:00,7,18,-11,No Signal,15469.8232421875
2023-09-14 16:30:00+00:00,9,17,-8,No Signal,15490.15625
2023-09-14 17:30:00+00:00,6,17,-11,No Signal,15463.8837890625
2023-09-14 18:30:00+00:00,4,31,-27,No Signal,15480.4912109375
2023-09-14 19:30:00+00:00,2,24,-22,No Signal,15474.310546875
2023-09-15 13:30:00+00:00,14,17,-3,No Signal,15308.9892578125
2023-09-15 14:30:00+00:00,26,10,16,Long,15243.2822265625
2023-09-15 15:30:00+00:00,25,11,14,No Signal,15248.3310546875
2023-09-15 16:30:00+00:00,30,5,25,No Signal,15194.5
2023-09-15 17:30:00+00:00,29,5,24,No Signal,15179.5224609375
2023-09-15 18:30:00+00:00,20,11,9,No Signal,15209.58203125
2023-09-15 19:30:00+00:00,20,6,14,No Signal,15202.7294921875
2023-09-18 13:30:00+00:00,17,2,15,No Signal,15220.822265625
2023-09-18 14:30:00+00:00,24,1,23,No Signal,15230.623046875
2023-09-18 15:30:00+00:00,21,2,19,No Signal,15260.7734375
2023-09-18 16:30:00+00:00,29,1,28,No Signal,15252.779296875
2023-09-18 17:30:00+00:00,28,2,26,No Signal,15240.8115234375
2023-09-18 18:30:00+00:00,40,0,40,No Signal,15215.171875
2023-09-18 19:30:00+00:00,35,0,35,No Signal,15225.9560546875
2023-09-19 13:30:00+00:00,33,1,32,No Signal,15114.9990234375
2023-09-19 14:30:00+00:00,25,1,24,No Signal,15097.94140625
2023-09-19 15:30:00+00:00,27,1,26,No Signal,15101.5
2023-09-19 16:30:00+00:00,18,3,15,No Signal,15137.2109375
2023-09-19 17:30:00+00:00,18,4,14,No Signal,15178.1728515625
2023-09-19 18:30:00+00:00,18,4,14,No Signal,15176.4326171875
2023-09-19 19:30:00+00:00,17,6,11,No Signal,15190.380859375
2023-09-20 13:30:00+00:00,15,14,1,No Signal,15188.484375
2023-09-20 14:30:00+00:00,14,12,2,No Signal,15152.3583984375
2023-09-20 15:30:00+00:00,11,13,-2,No Signal,15190.0673828125
2023-09-20 16:30:00+00:00,10,11,-1,No Signal,15185.33984375
2023-09-20 17:30:00+00:00,12,10,2,No Signal,15150.95703125
2023-09-20 18:30:00+00:00,16,7,9,No Signal,15069.779296875
2023-09-20 19:30:00+00:00,29,5,24,No Signal,14969.123046875
2023-09-21 13:30:00+00:00,30,3,27,No Signal,14797.1943359375
2023-09-21 14:30:00+00:00,38,4,34,No Signal,14774.8994140625
2023-09-21 15:30:00+00:00,38,2,36,No Signal,14775.1845703125
2023-09-21 16:30:00+00:00,37,0,37,No Signal,14816.6279296875
2023-09-21 17:30:00+00:00,47,1,46,No Signal,14765.076171875
2023-09-21 18:30:00+00:00,51,1,50,No Signal,14727.4345703125
2023-09-21 19:30:00+00:00,63,0,63,No Signal,14692.4267578125
2023-09-22 13:30:00+00:00,45,0,45,No Signal,14784.34765625
2023-09-22 14:30:00+00:00,34,1,33,No Signal,14843.3056640625
2023-09-22 15:30:00+00:00,39,1,38,No Signal,14833.7685546875
2023-09-22 16:30:00+00:00,47,0,47,No Signal,14776.4560546875
2023-09-22 17:30:00+00:00,46,1,45,No Signal,14722.4326171875
2023-09-22 18:30:00+00:00,30,0,30,No Signal,14785.2822265625
2023-09-22 19:30:00+00:00,33,1,32,No Signal,14701.373046875
2023-09-25 13:30:00+00:00,21,5,16,No Signal,14663.9501953125
2023-09-25 14:30:00+00:00,13,5,8,No Signal,14730.978515625
2023-09-25 15:30:00+00:00,12,7,5,No Signal,14761.1318359375
2023-09-25 16:30:00+00:00,15,5,10,No Signal,14720.572265625
2023-09-25 17:30:00+00:00,12,4,8,No Signal,14724.1416015625
2023-09-25 18:30:00+00:00,7,7,0,No Signal,14722.8720703125
2023-09-25 19:30:00+00:00,4,9,-5,No Signal,14768.10546875
2023-09-26 13:30:00+00:00,17,4,13,No Signal,14603.9521484375
2023-09-26 14:30:00+00:00,30,3,27,No Signal,14568.52734375
2023-09-26 15:30:00+00:00,26,1,25,No Signal,14603.0
2023-09-26 16:30:00+00:00,17,2,15,No Signal,14579.962890625
2023-09-26 17:30:00+00:00,19,2,17,No Signal,14546.7890625
2023-09-26 18:30:00+00:00,38,2,36,No Signal,14515.40625
2023-09-26 19:30:00+00:00,13,4,9,No Signal,14547.51953125
2023-09-27 13:30:00+00:00,9,10,-1,No Signal,14603.6943359375
2023-09-27 14:30:00+00:00,16,11,5,No Signal,14576.6767578125
2023-09-27 15:30:00+00:00,29,3,26,No Signal,14503.126953125
2023-09-27 16:30:00+00:00,31,4,27,No Signal,14461.521484375
2023-09-27 17:30:00+00:00,19,4,15,No Signal,14513.6953125
2023-09-27 18:30:00+00:00,14,5,9,No Signal,14606.267578125
2023-09-27 19:30:00+00:00,17,5,12,No Signal,14580.587890625
2023-09-28 13:30:00+00:00,13,8,5,No Signal,14573.955078125
2023-09-28 14:30:00+00:00,11,14,-3,No Signal,14667.7529296875
2023-09-28 15:30:00+00:00,9,24,-15,Short,14784.638671875
2023-09-28 16:30:00+00:00,7,17,-10,No Signal,14718.857421875
2023-09-28 17:30:00+00:00,7,18,-11,No Signal,14720.3408203125
2023-09-28 18:30:00+00:00,7,32,-25,No Signal,14753.7822265625
2023-09-28 19:30:00+00:00,7,15,-8,No Signal,14702.8837890625
2023-09-29 13:30:00+00:00,4,10,-6,No Signal,14828.6728515625
2023-09-29 14:30:00+00:00,3,14,-11,No Signal,14804.04296875
2023-09-29 15:30:00+00:00,2,33,-31,No Signal,14792.5
2023-09-29 16:30:00+00:00,1,24,-23,No Signal,14714.185546875
2023-09-29 17:30:00+00:00,3,10,-7,No Signal,14671.3369140625
2023-09-29 18:30:00+00:00,4,7,-3,No Signal,14725.33984375
2023-09-29 19:30:00+00:00,3,5,-2,No Signal,14717.8349609375
2023-10-02 13:30:00+00:00,6,13,-7,No Signal,14781.2275390625
2023-10-02 14:30:00+00:00,6,13,-7,No Signal,14887.388671875
2023-10-02 15:30:00+00:00,23,1,22,Long,14762.6875
2023-10-02 16:30:00+00:00,19,4,15,No Signal,14762.1826171875
2023-10-02 17:30:00+00:00,20,3,17,No Signal,14734.65234375
2023-10-02 18:30:00+00:00,21,1,20,No Signal,14766.9794921875
2023-10-02 19:30:00+00:00,9,5,4,No Signal,14838.236328125
2023-10-03 13:30:00+00:00,29,1,28,No Signal,14629.396484375
2023-10-03 14:30:00+00:00,36,0,36,No Signal,14591.1396484375
2023-10-03 15:30:00+00:00,33,1,32,No Signal,14620.529296875
2023-10-03 16:30:00+00:00,24,0,24,No Signal,14578.0263671875
2023-10-03 17:30:00+00:00,26,0,26,No Signal,14538.1572265625
2023-10-03 18:30:00+00:00,33,1,32,No Signal,14518.16796875
2023-10-03 19:30:00+00:00,25,0,25,No Signal,14565.8759765625
2023-10-04 13:30:00+00:00,22,2,20,No Signal,14593.5302734375
2023-10-04 14:30:00+00:00,21,0,21,No Signal,14690.9970703125
2023-10-04 15:30:00+00:00,8,3,5,No Signal,14729.9931640625
2023-10-04 16:30:00+00:00,13,0,13,No Signal,14687.3330078125
2023-10-04 17:30:00+00:00,13,3,10,No Signal,14692.412109375
2023-10-04 18:30:00+00:00,7,4,3,No Signal,14768.3203125
2023-10-04 19:30:00+00:00,9,3,6,No Signal,14769.05859375
2023-10-05 13:30:00+00:00,9,12,-3,No Signal,14662.814453125
2023-10-05 14:30:00+00:00,9,10,-1,No Signal,14620.6982421875
2023-10-05 15:30:00+00:00,7,10,-3,No Signal,14682.9853515625
2023-10-05 16:30:00+00:00,6,10,-4,No Signal,14676.3173828125
2023-10-05 17:30:00+00:00,3,24,-21,Short,14724.72265625
2023-10-05 18:30:00+00:00,3,30,-27,No Signal,14741.4150390625
2023-10-05 19:30:00+00:00,6,20,-14,No Signal,14724.953125
2023-10-06 13:30:00+00:00,6,24,-18,No Signal,14704.80078125
2023-10-06 14:30:00+00:00,5,21,-16,No Signal,14789.5458984375
2023-10-06 15:30:00+00:00,4,25,-21,No Signal,14900.953125
2023-10-06 16:30:00+00:00,3,41,-38,No Signal,14949.5107421875
2023-10-06 17:30:00+00:00,3,44,-41,No Signal,14986.3486328125
2023-10-06 18:30:00+00:00,5,35,-30,No Signal,15013.025390625
2023-10-06 19:30:00+00:00,5,28,-23,No Signal,14971.3427734375
2023-10-09 13:30:00+00:00,3,37,-34,No Signal,14894.4072265625
2023-10-09 14:30:00+00:00,3,41,-38,No Signal,14892.0048828125
2023-10-09 15:30:00+00:00,2,38,-36,No Signal,14929.6962890625
2023-10-09 16:30:00+00:00,1,44,-43,No Signal,14963.265625
2023-10-09 17:30:00+00:00,0,42,-42,No Signal,15055.201171875
2023-10-09 18:30:00+00:00,0,40,-40,No Signal,15052.453125
2023-10-09 19:30:00+00:00,0,43,-43,No Signal,15047.35546875
2023-10-10 13:30:00+00:00,0,59,-59,No Signal,15152.5771484375
2023-10-10 14:30:00+00:00,0,51,-51,No Signal,15211.859375
2023-10-10 15:30:00+00:00,0,47,-47,No Signal,15228.40625
2023-10-10 16:30:00+00:00,0,27,-27,No Signal,15149.5810546875
2023-10-10 17:30:00+00:00,0,21,-21,No Signal,15137.556640625
2023-10-10 18:30:00+00:00,0,17,-17,No Signal,15149.43359375
2023-10-10 19:30:00+00:00,0,26,-26,No Signal,15131.8037109375
2023-10-11 13:30:00+00:00,1,43,-42,No Signal,15179.0908203125
2023-10-11 14:30:00+00:00,0,42,-42,No Signal,15178.767578125
2023-10-11 15:30:00+00:00,1,32,-31,No Signal,15158.85546875
2023-10-11 16:30:00+00:00,3,25,-22,No Signal,15146.8037109375
2023-10-11 17:30:00+00:00,4,20,-16,No Signal,15172.9296875
2023-10-11 18:30:00+00:00,2,25,-23,No Signal,15204.962890625
2023-10-11 19:30:00+00:00,1,31,-30,No Signal,15240.2802734375
2023-10-12 13:30:00+00:00,21,21,0,No Signal,15289.732421875
2023-10-12 14:30:00+00:00,25,17,8,No Signal,15291.78125
2023-10-12 15:30:00+00:00,20,19,1,No Signal,15330.90234375
2023-10-12 16:30:00+00:00,23,7,16,Long,15181.271484375
2023-10-12 17:30:00+00:00,25,7,18,No Signal,15139.0849609375
2023-10-12 18:30:00+00:00,26,8,18,No Signal,15173.0517578125
2023-10-12 19:30:00+00:00,23,8,15,No Signal,15183.81640625
2023-10-13 13:30:00+00:00,25,8,17,No Signal,15150.4921875
2023-10-13 14:30:00+00:00,33,4,29,No Signal,15035.22265625
2023-10-13 15:30:00+00:00,30,6,24,No Signal,15056.9169921875
2023-10-13 16:30:00+00:00,34,3,31,No Signal,14957.3046875
2023-10-13 17:30:00+00:00,30,1,29,No Signal,14987.3798828125
2023-10-13 18:30:00+00:00,35,1,34,No Signal,14984.1123046875
2023-10-13 19:30:00+00:00,34,1,33,No Signal,14997.5078125
2023-10-16 13:30:00+00:00,11,3,8,No Signal,15173.1015625
2023-10-16 14:30:00+00:00,8,4,4,No Signal,15173.748046875
2023-10-16 15:30:00+00:00,13,4,9,No Signal,15157.5888671875
2023-10-16 16:30:00+00:00,8,14,-6,No Signal,15138.7685546875
2023-10-16 17:30:00+00:00,6,19,-13,Short,15180.97265625
2023-10-16 18:30:00+00:00,6,19,-13,No Signal,15207.548828125
2023-10-16 19:30:00+00:00,6,16,-10,No Signal,15166.0400390625
2023-10-17 13:30:00+00:00,8,15,-7,No Signal,15060.1044921875
2023-10-17 14:30:00+00:00,3,25,-22,No Signal,15116.271484375
2023-10-17 15:30:00+00:00,4,29,-25,No Signal,15184.85546875
2023-10-17 16:30:00+00:00,3,39,-36,No Signal,15139.732421875
2023-10-17 17:30:00+00:00,3,25,-22,No Signal,15099.16796875
2023-10-17 18:30:00+00:00,3,24,-21,No Signal,15095.150390625
2023-10-17 19:30:00+00:00,3,21,-18,No Signal,15120.7099609375
2023-10-18 13:30:00+00:00,12,7,5,No Signal,15042.7275390625
2023-10-18 14:30:00+00:00,13,5,8,No Signal,15013.03515625
2023-10-18 15:30:00+00:00,18,5,13,Long,14998.4560546875
2023-10-18 16:30:00+00:00,14,5,9,No Signal,15026.3515625
2023-10-18 17:30:00+00:00,20,6,14,No Signal,14981.32421875
2023-10-18 18:30:00+00:00,34,3,31,No Signal,14910.181640625
2023-10-18 19:30:00+00:00,29,3,26,No Signal,14904.5185546875
2023-10-19 13:30:00+00:00,33,1,32,No Signal,14907.3642578125
2023-10-19 14:30:00+00:00,37,3,34,No Signal,14904.896484375
2023-10-19 15:30:00+00:00,44,2,42,No Signal,14929.2197265625
2023-10-19 16:30:00+00:00,31,4,27,No Signal,14953.17578125
2023-10-19 17:30:00+00:00,38,2,36,No Signal,14881.5263671875
2023-10-19 18:30:00+00:00,48,2,46,No Signal,14778.7685546875
2023-10-19 19:30:00+00:00,50,2,48,No Signal,14780.54296875
2023-10-20 13:30:00+00:00,56,1,55,No Signal,14662.3095703125
2023-10-20 14:30:00+00:00,57,2,55,No Signal,14576.6279296875
2023-10-20 15:30:00+00:00,49,2,47,No Signal,14607.7216796875
2023-10-20 16:30:00+00:00,43,1,42,No Signal,14673.427734375
2023-10-20 17:30:00+00:00,48,1,47,No Signal,14610.20703125
2023-10-20 18:30:00+00:00,42,1,41,No Signal,14596.4775390625
2023-10-20 19:30:00+00:00,43,1,42,No Signal,14560.2900390625
2023-10-23 13:30:00+00:00,42,0,42,No Signal,14568.0380859375
2023-10-23 14:30:00+00:00,31,0,31,No Signal,14641.615234375
2023-10-23 15:30:00+00:00,26,0,26,No Signal,14682.12890625
2023-10-23 16:30:00+00:00,43,0,43,No Signal,14693.775390625
2023-10-23 17:30:00+00:00,31,0,31,No Signal,14682.1767578125
2023-10-23 18:30:00+00:00,23,0,23,No Signal,14636.4189453125
2023-10-23 19:30:00+00:00,29,0,29,No Signal,14607.9267578125
2023-10-24 13:30:00+00:00,4,8,-4,No Signal,14742.552734375
2023-10-24 14:30:00+00:00,5,16,-11,Short,14705.3447265625
2023-10-24 15:30:00+00:00,9,10,-1,No Signal,14646.837890625
2023-10-24 16:30:00+00:00,15,8,7,No Signal,14672.53125
2023-10-24 17:30:00+00:00,8,14,-6,No Signal,14706.4375
2023-10-24 18:30:00+00:00,6,19,-13,No Signal,14752.6962890625
2023-10-24 19:30:00+00:00,7,23,-16,No Signal,14745.6015625
2023-10-25 13:30:00+00:00,13,7,6,No Signal,14519.9365234375
2023-10-25 14:30:00+00:00,8,6,2,No Signal,14549.54296875
2023-10-25 15:30:00+00:00,16,5,11,Long,14485.2685546875
2023-10-25 16:30:00+00:00,24,3,21,No Signal,14414.6220703125
2023-10-25 17:30:00+00:00,21,2,19,No Signal,14394.57421875
2023-10-25 18:30:00+00:00,17,6,11,No Signal,14393.7724609375
2023-10-25 19:30:00+00:00,15,8,7,No Signal,14386.1181640625
2023-10-26 13:30:00+00:00,42,4,38,No Signal,14233.5556640625
2023-10-26 14:30:00+00:00,40,2,38,No Signal,14173.4912109375
2023-10-26 15:30:00+00:00,44,2,42,No Signal,14107.3505859375
2023-10-26 16:30:00+00:00,48,2,46,No Signal,14075.8896484375
2023-10-26 17:30:00+00:00,40,1,39,No Signal,14169.8876953125
2023-10-26 18:30:00+00:00,48,1,47,No Signal,14182.11328125
2023-10-26 19:30:00+00:00,52,1,51,No Signal,14109.6435546875
2023-10-27 13:30:00+00:00,29,3,26,No Signal,14244.796875
2023-10-27 14:30:00+00:00,26,3,23,No Signal,14304.892578125
2023-10-27 15:30:00+00:00,22,4,18,No Signal,14252.2724609375
2023-10-27 16:30:00+00:00,25,3,22,No Signal,14175.2490234375
2023-10-27 17:30:00+00:00,27,4,23,No Signal,14142.3916015625
2023-10-27 18:30:00+00:00,27,3,24,No Signal,14175.0400390625
2023-10-27 19:30:00+00:00,24,3,21,No Signal,14183.0771484375
2023-10-30 13:30:00+00:00,22,5,17,No Signal,14257.0048828125
2023-10-30 14:30:00+00:00,23,5,18,No Signal,14255.658203125
2023-10-30 15:30:00+00:00,18,9,9,No Signal,14263.9638671875
2023-10-30 16:30:00+00:00,9,8,1,No Signal,14311.6435546875
2023-10-30 17:30:00+00:00,15,9,6,No Signal,14323.5166015625
2023-10-30 18:30:00+00:00,7,7,0,No Signal,14365.1904296875
2023-10-30 19:30:00+00:00,8,11,-3,No Signal,14333.2734375
2023-10-31 13:30:00+00:00,5,11,-6,No Signal,14316.6298828125
2023-10-31 14:30:00+00:00,7,9,-2,No Signal,14300.587890625
2023-10-31 15:30:00+00:00,5,13,-8,No Signal,14314.7041015625
2023-10-31 16:30:00+00:00,3,31,-28,Short,14350.2685546875
2023-10-31 17:30:00+00:00,3,41,-38,No Signal,14365.140625
2023-10-31 18:30:00+00:00,2,40,-38,No Signal,14404.970703125
2023-10-31 19:30:00+00:00,1,39,-38,No Signal,14410.08203125
2023-11-01 13:30:00+00:00,2,45,-43,No Signal,14548.400390625
2023-11-01 14:30:00+00:00,6,25,-19,No Signal,14509.158203125
2023-11-01 15:30:00+00:00,4,27,-23,No Signal,14512.8955078125
2023-11-01 16:30:00+00:00,5,23,-18,No Signal,14515.193359375
2023-11-01 17:30:00+00:00,5,20,-15,No Signal,14533.0615234375
2023-11-01 18:30:00+00:00,3,26,-23,No Signal,14647.23046875
2023-11-01 19:30:00+00:00,2,35,-33,No Signal,14663.1689453125
2023-11-02 13:30:00+00:00,3,52,-49,No Signal,14850.04296875
2023-11-02 14:30:00+00:00,4,56,-52,No Signal,14863.958984375
2023-11-02 15:30:00+00:00,3,51,-48,No Signal,14862.751953125
2023-11-02 16:30:00+00:00,1,53,-52,No Signal,14893.0146484375
2023-11-02 17:30:00+00:00,3,54,-51,No Signal,14915.55859375
2023-11-02 18:30:00+00:00,2,51,-49,No Signal,14914.8330078125
2023-11-02 19:30:00+00:00,2,50,-48,No Signal,14921.7939453125
2023-11-03 13:30:00+00:00,3,64,-61,No Signal,14994.8349609375
2023-11-03 14:30:00+00:00,1,68,-67,No Signal,15028.3837890625
2023-11-03 15:30:00+00:00,1,74,-73,No Signal,15105.5498046875
2023-11-03 16:30:00+00:00,1,70,-69,No Signal,15089.181640625
2023-11-03 17:30:00+00:00,1,70,-69,No Signal,15126.0576171875
2023-11-03 18:30:00+00:00,1,59,-58,No Signal,15118.353515625
2023-11-03 19:30:00+00:00,1,60,-59,No Signal,15099.634765625
2023-11-06 14:30:00+00:00,4,35,-31,No Signal,15135.2900390625
2023-11-06 15:30:00+00:00,2,33,-31,No Signal,15146.302734375
2023-11-06 16:30:00+00:00,2,30,-28,No Signal,15127.03515625
2023-11-06 17:30:00+00:00,4,21,-17,No Signal,15078.0654296875
2023-11-06 18:30:00+00:00,5,24,-19,No Signal,15096.279296875
2023-11-06 19:30:00+00:00,4,28,-24,No Signal,15129.2646484375
2023-11-06 20:30:00+00:00,3,31,-28,No Signal,15156.990234375
2023-11-07 14:30:00+00:00,5,22,-17,No Signal,15261.302734375
2023-11-07 15:30:00+00:00,6,23,-17,No Signal,15311.2216796875
2023-11-07 16:30:00+00:00,11,11,0,No Signal,15273.1865234375
2023-11-07 17:30:00+00:00,10,16,-6,No Signal,15316.17578125
2023-11-07 18:30:00+00:00,12,13,-1,No Signal,15327.60546875
2023-11-07 19:30:00+00:00,12,17,-5,No Signal,15321.8271484375
2023-11-07 20:30:00+00:00,9,16,-7,No Signal,15297.21875
2023-11-08 14:30:00+00:00,13,25,-12,No Signal,15275.181640625
2023-11-08 15:30:00+00:00,13,25,-12,No Signal,15276.1953125
2023-11-08 16:30:00+00:00,17,17,0,No Signal,15242.0205078125
2023-11-08 17:30:00+00:00,12,31,-19,No Signal,15283.38671875
2023-11-08 18:30:00+00:00,12,32,-20,No Signal,15309.3271484375
2023-11-08 19:30:00+00:00,11,25,-14,No Signal,15297.3017578125
2023-11-08 20:30:00+00:00,9,22,-13,No Signal,15313.5361328125
2023-11-09 14:30:00+00:00,18,17,1,No Signal,15293.65234375
2023-11-09 15:30:00+00:00,18,19,-1,No Signal,15340.3251953125
2023-11-09 16:30:00+00:00,17,19,-2,No Signal,15327.1279296875
2023-11-09 17:30:00+00:00,19,13,6,No Signal,15311.7900390625
2023-11-09 18:30:00+00:00,25,4,21,Long,15247.109375
2023-11-09 19:30:00+00:00,31,2,29,No Signal,15188.6962890625
2023-11-09 20:30:00+00:00,32,2,30,No Signal,15187.5771484375
2023-11-10 14:30:00+00:00,22,6,16,No Signal,15264.7978515625
2023-11-10 15:30:00+00:00,11,8,3,No Signal,15366.8388671875
2023-11-10 16:30:00+00:00,8,21,-13,Short,15408.453125
2023-11-10 17:30:00+00:00,7,22,-15,No Signal,15467.3916015625
2023-11-10 18:30:00+00:00,4,24,-20,No Signal,15502.505859375
2023-11-10 19:30:00+00:00,4,28,-24,No Signal,15521.708984375
2023-11-10 20:30:00+00:00,4,24,-20,No Signal,15530.10546875
2023-11-13 14:30:00+00:00,2,14,-12,No Signal,15457.3330078125
2023-11-13 15:30:00+00:00,5,12,-7,No Signal,15503.3076171875
2023-11-13 16:30:00+00:00,2,19,-17,No Signal,15490.931640625
2023-11-13 17:30:00+00:00,4,19,-15,No Signal,15482.431640625
2023-11-13 18:30:00+00:00,3,35,-32,No Signal,15519.55859375
2023-11-13 19:30:00+00:00,3,47,-44,No Signal,15508.73828125
2023-11-13 20:30:00+00:00,3,47,-44,No Signal,15483.201171875
2023-11-14 14:30:00+00:00,1,73,-72,No Signal,15812.716796875
2023-11-14 15:30:00+00:00,2,63,-61,No Signal,15801.755859375
2023-11-14 16:30:00+00:00,1,52,-51,No Signal,15773.3037109375
2023-11-14 17:30:00+00:00,2,45,-43,No Signal,15811.4365234375
2023-11-14 18:30:00+00:00,3,37,-34,No Signal,15787.5107421875
2023-11-14 19:30:00+00:00,2,42,-40,No Signal,15842.2509765625
2023-11-14 20:30:00+00:00,2,37,-35,No Signal,15811.1201171875
2023-11-15 14:30:00+00:00,3,63,-60,No Signal,15866.7236328125
2023-11-15 15:30:00+00:00,3,59,-56,No Signal,15888.080078125
2023-11-15 16:30:00+00:00,3,51,-48,No Signal,15836.6357421875
2023-11-15 17:30:00+00:00,3,49,-46,No Signal,15815.3203125
2023-11-15 18:30:00+00:00,4,52,-48,No Signal,15848.443359375
2023-11-15 19:30:00+00:00,4,49,-45,No Signal,15826.57421875
2023-11-15 20:30:00+00:00,4,50,-46,No Signal,15820.9814453125
2023-11-16 14:30:00+00:00,8,5,3,No Signal,15815.74609375
2023-11-16 15:30:00+00:00,9,6,3,No Signal,15750.4765625
2023-11-16 16:30:00+00:00,6,10,-4,No Signal,15811.7822265625
2023-11-16 17:30:00+00:00,8,11,-3,No Signal,15805.345703125
2023-11-16 18:30:00+00:00,7,11,-4,No Signal,15791.701171875
2023-11-16 19:30:00+00:00,7,10,-3,No Signal,15811.5244140625
2023-11-16 20:30:00+00:00,5,9,-4,No Signal,15834.068359375
2023-11-17 14:30:00+00:00,18,4,14,Long,15809.56640625
2023-11-17 15:30:00+00:00,20,4,16,No Signal,15797.1728515625
2023-11-17 16:30:00+00:00,14,6,8,No Signal,15808.912109375
2023-11-17 17:30:00+00:00,9,8,1,No Signal,15846.455078125
2023-11-17 18:30:00+00:00,13,6,7,No Signal,15857.173828125
2023-11-17 19:30:00+00:00,10,8,2,No Signal,15849.5888671875
2023-11-17 20:30:00+00:00,9,8,1,No Signal,15837.7099609375
2023-11-20 14:30:00+00:00,6,17,-11,Short,15902.93359375
2023-11-20 15:30:00+00:00,4,39,-35,No Signal,15950.275390625
2023-11-20 16:30:00+00:00,5,30,-25,No Signal,15961.0751953125
2023-11-20 17:30:00+00:00,3,40,-37,No Signal,16011.482421875
2023-11-20 18:30:00+00:00,5,44,-39,No Signal,16013.2841796875
2023-11-20 19:30:00+00:00,1,47,-46,No Signal,16047.4853515625
2023-11-20 20:30:00+00:00,2,38,-36,No Signal,16030.2587890625
2023-11-21 14:30:00+00:00,7,15,-8,No Signal,15875.8173828125
2023-11-21 15:30:00+00:00,3,23,-20,No Signal,15893.8828125
2023-11-21 16:30:00+00:00,5,23,-18,No Signal,15919.7734375
2023-11-21 17:30:00+00:00,6,21,-15,No Signal,15901.923828125
2023-11-21 18:30:00+00:00,3,20,-17,No Signal,15921.2197265625
2023-11-21 19:30:00+00:00,5,21,-16,No Signal,15937.7890625
2023-11-21 20:30:00+00:00,3,19,-16,No Signal,15936.4619140625
2023-11-22 14:30:00+00:00,1,28,-27,No Signal,16013.4853515625
2023-11-22 15:30:00+00:00,3,25,-22,No Signal,16014.9501953125
2023-11-22 16:30:00+00:00,3,26,-23,No Signal,16042.3994140625
2023-11-22 17:30:00+00:00,2,20,-18,No Signal,16053.0771484375
2023-11-22 18:30:00+00:00,1,20,-19,No Signal,16039.5185546875
2023-11-22 19:30:00+00:00,10,10,0,No Signal,16009.4052734375
2023-11-22 20:30:00+00:00,7,12,-5,No Signal,16001.3720703125
2023-11-24 14:30:00+00:00,2,24,-22,No Signal,15951.7236328125
2023-11-24 15:30:00+00:00,2,23,-21,No Signal,15962.0673828125
2023-11-24 16:30:00+00:00,7,22,-15,No Signal,15971.55078125
2023-11-27 14:30:00+00:00,2,16,-14,No Signal,15975.8916015625
2023-11-27 15:30:00+00:00,2,19,-17,No Signal,15984.7666015625
2023-11-27 16:30:00+00:00,0,19,-19,No Signal,16018.31640625
2023-11-27 17:30:00+00:00,3,22,-19,No Signal,16025.1376953125
2023-11-27 18:30:00+00:00,10,6,4,No Signal,15997.1767578125
2023-11-27 19:30:00+00:00,9,6,3,No Signal,15994.3525390625
2023-11-27 20:30:00+00:00,13,4,9,No Signal,15963.298828125
2023-11-28 14:30:00+00:00,20,6,14,Long,15947.2119140625
2023-11-28 15:30:00+00:00,10,10,0,No Signal,16000.732421875
2023-11-28 16:30:00+00:00,9,11,-2,No Signal,16002.98046875
2023-11-28 17:30:00+00:00,13,10,3,No Signal,15962.4052734375
2023-11-28 18:30:00+00:00,17,9,8,No Signal,15958.6201171875
2023-11-28 19:30:00+00:00,17,9,8,No Signal,15964.751953125
2023-11-28 20:30:00+00:00,14,9,5,No Signal,16008.3203125
2023-11-29 14:30:00+00:00,12,21,-9,No Signal,16070.79296875
2023-11-29 15:30:00+00:00,17,14,3,No Signal,16006.1962890625
2023-11-29 16:30:00+00:00,10,15,-5,No Signal,16051.1982421875
2023-11-29 17:30:00+00:00,11,15,-4,No Signal,16048.318359375
2023-11-29 18:30:00+00:00,13,14,-1,No Signal,16031.3642578125
2023-11-29 19:30:00+00:00,15,11,4,No Signal,15985.9033203125
2023-11-29 20:30:00+00:00,13,13,0,No Signal,15988.1162109375
2023-11-30 14:30:00+00:00,17,17,0,No Signal,15915.5107421875
2023-11-30 15:30:00+00:00,21,13,8,No Signal,15861.9140625
2023-11-30 16:30:00+00:00,24,12,12,No Signal,15844.833984375
2023-11-30 17:30:00+00:00,19,13,6,No Signal,15836.90234375
2023-11-30 18:30:00+00:00,17,13,4,No Signal,15854.4677734375
2023-11-30 19:30:00+00:00,16,12,4,No Signal,15851.2138671875
2023-11-30 20:30:00+00:00,6,14,-8,No Signal,15950.1416015625
2023-12-01 14:30:00+00:00,21,6,15,No Signal,15848.638671875
2023-12-01 15:30:00+00:00,9,12,-3,No Signal,15929.681640625
2023-12-01 16:30:00+00:00,9,12,-3,No Signal,15984.7822265625
2023-12-01 17:30:00+00:00,10,14,-4,No Signal,15976.9521484375
2023-12-01 18:30:00+00:00,7,12,-5,No Signal,15984.2578125
2023-12-01 19:30:00+00:00,5,25,-20,Short,15997.96875
2023-12-01 20:30:00+00:00,5,30,-25,No Signal,15993.77734375
2023-12-04 14:30:00+00:00,13,21,-8,No Signal,15727.248046875
2023-12-04 15:30:00+00:00,9,21,-12,No Signal,15740.521484375
2023-12-04 16:30:00+00:00,3,29,-26,No Signal,15808.771484375
2023-12-04 17:30:00+00:00,4,26,-22,No Signal,15792.9501953125
2023-12-04 18:30:00+00:00,5,23,-18,No Signal,15798.2783203125
2023-12-04 19:30:00+00:00,6,22,-16,No Signal,15803.3076171875
2023-12-04 20:30:00+00:00,6,20,-14,No Signal,15838.373046875
2023-12-05 14:30:00+00:00,3,8,-5,No Signal,15862.15234375
2023-12-05 15:30:00+00:00,15,8,7,No Signal,15852.6240234375
2023-12-05 16:30:00+00:00,22,6,16,Long,15859.1435546875
2023-12-05 17:30:00+00:00,24,6,18,No Signal,15847.953125
2023-12-05 18:30:00+00:00,19,5,14,No Signal,15865.3740234375
2023-12-05 19:30:00+00:00,20,5,15,No Signal,15868.869140625
2023-12-05 20:30:00+00:00,18,3,15,No Signal,15879.0712890625
2023-12-06 14:30:00+00:00,8,19,-11,Short,15870.392578125
2023-12-06 15:30:00+00:00,9,20,-11,No Signal,15886.2578125
2023-12-06 16:30:00+00:00,8,13,-5,No Signal,15871.5693359375
2023-12-06 17:30:00+00:00,7,13,-6,No Signal,15853.87890625
2023-12-06 18:30:00+00:00,9,10,-1,No Signal,15839.5234375
2023-12-06 19:30:00+00:00,10,6,4,No Signal,15802.3544921875
2023-12-06 20:30:00+00:00,15,4,11,Long,15791.09765625
2023-12-07 14:30:00+00:00,5,21,-16,Short,15973.1923828125
2023-12-07 15:30:00+00:00,8,17,-9,No Signal,15949.029296875
2023-12-07 16:30:00+00:00,5,19,-14,No Signal,16026.693359375
2023-12-07 17:30:00+00:00,5,22,-17,No Signal,16004.5166015625
2023-12-07 18:30:00+00:00,4,27,-23,No Signal,16036.814453125
2023-12-07 19:30:00+00:00,5,24,-19,No Signal,16019.19140625
2023-12-07 20:30:00+00:00,11,20,-9,No Signal,16021.673828125
2023-12-08 14:30:00+00:00,6,17,-11,No Signal,16083.8955078125
2023-12-08 15:30:00+00:00,11,7,4,No Signal,16034.224609375
2023-12-08 16:30:00+00:00,10,9,1,No Signal,16040.126953125
2023-12-08 17:30:00+00:00,9,16,-7,No Signal,16061.5439453125
2023-12-08 18:30:00+00:00,6,23,-17,No Signal,16082.638671875
2023-12-08 19:30:00+00:00,7,32,-25,No Signal,16093.39453125
2023-12-08 20:30:00+00:00,7,28,-21,No Signal,16082.67578125
2023-12-11 14:30:00+00:00,9,40,-31,No Signal,16132.2861328125
2023-12-11 15:30:00+00:00,5,42,-37,No Signal,16138.68359375
2023-12-11 16:30:00+00:00,4,40,-36,No Signal,16174.134765625
2023-12-11 17:30:00+00:00,3,38,-35,No Signal,16209.2333984375
2023-12-11 18:30:00+00:00,4,39,-35,No Signal,16221.3173828125
2023-12-11 19:30:00+00:00,4,37,-33,No Signal,16202.91796875
2023-12-11 20:30:00+00:00,3,38,-35,No Signal,16223.2373046875
2023-12-12 14:30:00+00:00,8,40,-32,No Signal,16246.8779296875
2023-12-12 15:30:00+00:00,7,53,-46,No Signal,16274.34375
2023-12-12 16:30:00+00:00,8,52,-44,No Signal,16267.1025390625
2023-12-12 17:30:00+00:00,9,52,-43,No Signal,16281.701171875
2023-12-12 18:30:00+00:00,5,53,-48,No Signal,16308.5908203125
2023-12-12 19:30:00+00:00,6,52,-46,No Signal,16339.4033203125
2023-12-12 20:30:00+00:00,7,58,-51,No Signal,16353.8720703125
2023-12-13 14:30:00+00:00,6,36,-30,No Signal,16405.9765625
2023-12-13 15:30:00+00:00,9,34,-25,No Signal,16388.060546875
2023-12-13 16:30:00+00:00,11,36,-25,No Signal,16385.296875
2023-12-13 17:30:00+00:00,15,29,-14,No Signal,16361.2587890625
2023-12-13 18:30:00+00:00,5,40,-35,No Signal,16476.771484375
2023-12-13 19:30:00+00:00,1,48,-47,No Signal,16497.7421875
2023-12-13 20:30:00+00:00,1,53,-52,No Signal,16560.232421875
2023-12-14 14:30:00+00:00,3,45,-42,No Signal,16576.34375
2023-12-14 15:30:00+00:00,4,45,-41,No Signal,16554.517578125
2023-12-14 16:30:00+00:00,4,48,-44,No Signal,16598.3984375
2023-12-14 17:30:00+00:00,4,31,-27,No Signal,16473.611328125
2023-12-14 18:30:00+00:00,3,26,-23,No Signal,16509.669921875
2023-12-14 19:30:00+00:00,6,28,-22,No Signal,16518.515625
2023-12-14 20:30:00+00:00,6,31,-25,No Signal,16539.92578125
2023-12-15 14:30:00+00:00,8,32,-24,No Signal,16651.951171875
2023-12-15 15:30:00+00:00,8,34,-26,No Signal,16657.66015625
2023-12-15 16:30:00+00:00,7,31,-24,No Signal,16647.982421875
2023-12-15 17:30:00+00:00,7,32,-25,No Signal,16621.09375
2023-12-15 18:30:00+00:00,12,22,-10,No Signal,16580.87109375
2023-12-15 19:30:00+00:00,15,20,-5,No Signal,16618.41015625
2023-12-15 20:30:00+00:00,17,17,0,No Signal,16607.109375
2023-12-18 14:30:00+00:00,15,8,7,No Signal,16695.171875
2023-12-18 15:30:00+00:00,12,9,3,No Signal,16691.392578125
2023-12-18 16:30:00+00:00,13,8,5,No Signal,16718.4140625
2023-12-18 17:30:00+00:00,10,17,-7,No Signal,16738.544921875
2023-12-18 18:30:00+00:00,10,15,-5,No Signal,16746.3046875
2023-12-18 19:30:00+00:00,10,19,-9,No Signal,16761.63671875
2023-12-18 20:30:00+00:00,11,14,-3,No Signal,16730.51171875
2023-12-19 14:30:00+00:00,7,18,-11,No Signal,16781.212890625
2023-12-19 15:30:00+00:00,11,19,-8,No Signal,16787.70703125
2023-12-19 16:30:00+00:00,7,16,-9,No Signal,16773.693359375
2023-12-19 17:30:00+00:00,5,17,-12,No Signal,16778.681640625
2023-12-19 18:30:00+00:00,3,23,-20,No Signal,16793.953125
2023-12-19 19:30:00+00:00,3,23,-20,No Signal,16785.27734375
2023-12-19 20:30:00+00:00,1,24,-23,No Signal,16811.8984375
2023-12-20 14:30:00+00:00,4,28,-24,No Signal,16840.009765625
2023-12-20 15:30:00+00:00,6,27,-21,No Signal,16830.900390625
2023-12-20 16:30:00+00:00,7,27,-20,No Signal,16832.099609375
2023-12-20 17:30:00+00:00,5,20,-15,No Signal,16847.169921875
2023-12-20 18:30:00+00:00,7,18,-11,No Signal,16799.96484375
2023-12-20 19:30:00+00:00,22,3,19,Long,16587.65234375
2023-12-20 20:30:00+00:00,26,1,25,No Signal,16555.1875
2023-12-21 14:30:00+00:00,9,2,7,No Signal,16679.68359375
2023-12-21 15:30:00+00:00,9,3,6,No Signal,16696.53125
2023-12-21 16:30:00+00:00,10,1,9,No Signal,16640.41796875
2023-12-21 17:30:00+00:00,10,2,8,No Signal,16664.9765625
2023-12-21 18:30:00+00:00,10,2,8,No Signal,16680.8515625
2023-12-21 19:30:00+00:00,7,2,5,No Signal,16738.16015625
2023-12-21 20:30:00+00:00,8,2,6,No Signal,16757.544921875
2023-12-22 14:30:00+00:00,8,7,1,No Signal,16826.509765625
2023-12-22 15:30:00+00:00,8,5,3,No Signal,16800.685546875
2023-12-22 16:30:00+00:00,8,6,2,No Signal,16791.28515625
2023-12-22 17:30:00+00:00,8,7,1,No Signal,16816.46484375
2023-12-22 18:30:00+00:00,10,3,7,No Signal,16719.267578125
2023-12-22 19:30:00+00:00,3,32,-29,Short,16789.73046875
2023-12-22 20:30:00+00:00,3,38,-35,No Signal,16780.5625
2023-12-26 14:30:00+00:00,2,19,-17,No Signal,16844.853515625
2023-12-26 15:30:00+00:00,3,17,-14,No Signal,16837.119140625
2023-12-26 16:30:00+00:00,3,37,-34,No Signal,16846.1484375
2023-12-26 17:30:00+00:00,3,37,-34,No Signal,16858.65625
2023-12-26 18:30:00+00:00,2,35,-33,No Signal,16860.771484375
2023-12-26 19:30:00+00:00,3,35,-32,No Signal,16898.41796875
2023-12-26 20:30:00+00:00,4,22,-18,No Signal,16879.103515625
2023-12-27 14:30:00+00:00,5,10,-5,No Signal,16883.201171875
2023-12-27 15:30:00+00:00,6,12,-6,No Signal,16877.462890625
2023-12-27 16:30:00+00:00,5,14,-9,No Signal,16890.05859375
2023-12-27 17:30:00+00:00,5,14,-9,No Signal,16907.966796875
2023-12-27 18:30:00+00:00,3,37,-34,No Signal,16895.6953125
2023-12-27 19:30:00+00:00,5,24,-19,No Signal,16884.900390625
2023-12-27 20:30:00+00:00,2,31,-29,No Signal,16910.322265625
2023-12-28 14:30:00+00:00,9,27,-18,No Signal,16940.458984375
2023-12-28 15:30:00+00:00,9,27,-18,No Signal,16926.68359375
2023-12-28 16:30:00+00:00,5,20,-15,No Signal,16931.556640625
2023-12-28 17:30:00+00:00,5,19,-14,No Signal,16929.447265625
2023-12-28 18:30:00+00:00,4,17,-13,No Signal,16937.421875
2023-12-28 19:30:00+00:00,15,10,5,No Signal,16912.138671875
2023-12-28 20:30:00+00:00,12,11,1,No Signal,16902.330078125
2023-12-29 14:30:00+00:00,14,18,-4,No Signal,16905.158203125
2023-12-29 15:30:00+00:00,31,8,23,Long,16758.26953125
2023-12-29 16:30:00+00:00,25,4,21,No Signal,16765.34375
2023-12-29 17:30:00+00:00,15,4,11,No Signal,16813.76171875
2023-12-29 18:30:00+00:00,12,6,6,No Signal,16831.337890625
2023-12-29 19:30:00+00:00,9,8,1,No Signal,16848.45703125
2023-12-29 20:30:00+00:00,16,4,12,No Signal,16828.087890625
2024-01-02 14:30:00+00:00,51,13,38,No Signal,16551.90234375
2024-01-02 15:30:00+00:00,45,10,35,No Signal,16584.28125
2024-01-02 16:30:00+00:00,47,14,33,No Signal,16585.501953125
2024-01-02 17:30:00+00:00,50,12,38,No Signal,16559.2265625
2024-01-02 18:30:00+00:00,53,11,42,No Signal,16526.5390625
2024-01-02 19:30:00+00:00,54,10,44,No Signal,16471.232421875
2024-01-02 20:30:00+00:00,41,13,28,No Signal,16545.279296875
2024-01-03 14:30:00+00:00,57,9,48,No Signal,16412.8515625
2024-01-03 15:30:00+00:00,48,10,38,No Signal,16417.81640625
2024-01-03 16:30:00+00:00,48,11,37,No Signal,16404.166015625
2024-01-03 17:30:00+00:00,53,11,42,No Signal,16418.126953125
2024-01-03 18:30:00+00:00,49,12,37,No Signal,16444.427734375
2024-01-03 19:30:00+00:00,56,7,49,No Signal,16386.330078125
2024-01-03 20:30:00+00:00,56,7,49,No Signal,16367.3486328125
2024-01-04 14:30:00+00:00,35,8,27,No Signal,16347.302734375
2024-01-04 15:30:00+00:00,30,7,23,No Signal,16405.185546875
2024-01-04 16:30:00+00:00,34,4,30,No Signal,16362.9658203125
2024-01-04 17:30:00+00:00,31,4,27,No Signal,16355.6123046875
2024-01-04 18:30:00+00:00,30,4,26,No Signal,16321.33984375
2024-01-04 19:30:00+00:00,20,7,13,No Signal,16325.7119140625
2024-01-04 20:30:00+00:00,34,2,32,No Signal,16285.38671875
2024-01-05 14:30:00+00:00,15,11,4,No Signal,16380.9619140625
2024-01-05 15:30:00+00:00,21,12,9,No Signal,16365.255859375
2024-01-05 16:30:00+00:00,22,8,14,No Signal,16300.0263671875
2024-01-05 17:30:00+00:00,27,9,18,No Signal,16311.9931640625
2024-01-05 18:30:00+00:00,28,7,21,No Signal,16321.2734375
2024-01-05 19:30:00+00:00,27,5,22,No Signal,16262.5732421875
2024-01-05 20:30:00+00:00,19,6,13,No Signal,16303.3359375
2024-01-08 14:30:00+00:00,15,16,-1,No Signal,16481.572265625
2024-01-08 15:30:00+00:00,17,14,3,No Signal,16490.857421875
2024-01-08 16:30:00+00:00,10,13,-3,No Signal,16525.9453125
2024-01-08 17:30:00+00:00,10,19,-9,No Signal,16555.626953125
2024-01-08 18:30:00+00:00,6,27,-21,Short,16597.150390625
2024-01-08 19:30:00+00:00,5,20,-15,No Signal,16620.90625
2024-01-08 20:30:00+00:00,2,44,-42,No Signal,16645.5859375
2024-01-09 14:30:00+00:00,5,26,-21,No Signal,16573.236328125
2024-01-09 15:30:00+00:00,3,28,-25,No Signal,16627.138671875
2024-01-09 16:30:00+00:00,2,45,-43,No Signal,16673.4609375
2024-01-09 17:30:00+00:00,3,40,-37,No Signal,16676.8359375
2024-01-09 18:30:00+00:00,2,34,-32,No Signal,16661.5234375
2024-01-09 19:30:00+00:00,2,47,-45,No Signal,16669.57421875
2024-01-09 20:30:00+00:00,2,45,-43,No Signal,16676.6328125
2024-01-10 14:30:00+00:00,1,25,-24,No Signal,16708.478515625
2024-01-10 15:30:00+00:00,4,24,-20,No Signal,16716.494140625
2024-01-10 16:30:00+00:00,9,26,-17,No Signal,16736.935546875
2024-01-10 17:30:00+00:00,8,23,-15,No Signal,16753.3125
2024-01-10 18:30:00+00:00,6,23,-17,No Signal,16798.564453125
2024-01-10 19:30:00+00:00,7,22,-15,No Signal,16786.509765625
2024-01-10 20:30:00+00:00,10,21,-11,No Signal,16792.169921875
2024-01-11 14:30:00+00:00,12,22,-10,No Signal,16749.35546875
2024-01-11 15:30:00+00:00,19,9,10,Long,16655.396484375
2024-01-11 16:30:00+00:00,21,6,15,No Signal,16647.61328125
2024-01-11 17:30:00+00:00,10,11,-1,No Signal,16745.916015625
2024-01-11 18:30:00+00:00,6,17,-11,Short,16802.447265625
2024-01-11 19:30:00+00:00,7,15,-8,No Signal,16803.09375
2024-01-11 20:30:00+00:00,8,16,-8,No Signal,16818.806640625
2024-01-12 14:30:00+00:00,7,16,-9,No Signal,16823.390625
2024-01-12 15:30:00+00:00,5,18,-13,No Signal,16843.08203125
2024-01-12 16:30:00+00:00,8,16,-8,No Signal,16803.7265625
2024-01-12 17:30:00+00:00,8,15,-7,No Signal,16830.263671875
2024-01-12 18:30:00+00:00,15,13,2,No Signal,16833.0625
2024-01-12 19:30:00+00:00,13,13,0,No Signal,16813.62890625
2024-01-12 20:30:00+00:00,16,15,1,No Signal,16829.484375
2024-01-16 14:30:00+00:00,13,18,-5,No Signal,16860.595703125
2024-01-16 15:30:00+00:00,14,26,-12,No Signal,16861.93359375
2024-01-16 16:30:00+00:00,16,21,-5,No Signal,16784.74609375
2024-01-16 17:30:00+00:00,20,16,4,No Signal,16798.78515625
2024-01-16 18:30:00+00:00,30,7,23,Long,16757.03125
2024-01-16 19:30:00+00:00,22,6,16,No Signal,16791.49609375
2024-01-16 20:30:00+00:00,20,11,9,No Signal,16829.462890625
2024-01-17 14:30:00+00:00,38,3,35,No Signal,16622.2421875
2024-01-17 15:30:00+00:00,37,2,35,No Signal,16689.880859375
2024-01-17 16:30:00+00:00,36,3,33,No Signal,16659.474609375
2024-01-17 17:30:00+00:00,39,3,36,No Signal,16638.474609375
2024-01-17 18:30:00+00:00,34,4,30,No Signal,16669.57421875
2024-01-17 19:30:00+00:00,33,3,30,No Signal,16670.41796875
2024-01-17 20:30:00+00:00,22,6,16,No Signal,16737.748046875
2024-01-18 14:30:00+00:00,7,4,3,No Signal,16904.0625
2024-01-18 15:30:00+00:00,6,6,0,No Signal,16956.802734375
2024-01-18 16:30:00+00:00,6,6,0,No Signal,16894.96875
2024-01-18 17:30:00+00:00,9,3,6,No Signal,16830.853515625
2024-01-18 18:30:00+00:00,6,11,-5,No Signal,16963.9140625
2024-01-18 19:30:00+00:00,3,12,-9,No Signal,16978.91796875
2024-01-18 20:30:00+00:00,3,8,-5,No Signal,16981.380859375
2024-01-19 14:30:00+00:00,3,48,-45,Short,17089.6015625
2024-01-19 15:30:00+00:00,3,39,-36,No Signal,17128.443359375
2024-01-19 16:30:00+00:00,2,49,-47,No Signal,17156.75390625
2024-01-19 17:30:00+00:00,1,59,-58,No Signal,17220.08984375
2024-01-19 18:30:00+00:00,1,64,-63,No Signal,17280.314453125
2024-01-19 19:30:00+00:00,1,61,-60,No Signal,17298.46875
2024-01-19 20:30:00+00:00,1,54,-53,No Signal,17310.65625
2024-01-22 14:30:00+00:00,2,57,-55,No Signal,17356.611328125
2024-01-22 15:30:00+00:00,2,51,-49,No Signal,17364.25
2024-01-22 16:30:00+00:00,3,54,-51,No Signal,17363.2421875
2024-01-22 17:30:00+00:00,2,49,-47,No Signal,17311.373046875
2024-01-22 18:30:00+00:00,3,47,-44,No Signal,17333.58984375
2024-01-22 19:30:00+00:00,2,45,-43,No Signal,17358.703125
2024-01-22 20:30:00+00:00,3,38,-35,No Signal,17329.17578125
2024-01-23 14:30:00+00:00,2,36,-34,No Signal,17338.017578125
2024-01-23 15:30:00+00:00,2,23,-21,No Signal,17317.900390625
2024-01-23 16:30:00+00:00,3,22,-19,No Signal,17326.12109375
2024-01-23 17:30:00+00:00,4,16,-12,No Signal,17351.578125
2024-01-23 18:30:00+00:00,6,13,-7,No Signal,17347.5703125
2024-01-23 19:30:00+00:00,5,17,-12,No Signal,17384.234375
2024-01-23 20:30:00+00:00,6,20,-14,No Signal,17401.93359375
2024-01-24 14:30:00+00:00,9,22,-13,No Signal,17590.7890625
2024-01-24 15:30:00+00:00,6,23,-17,No Signal,17583.986328125
2024-01-24 16:30:00+00:00,8,24,-16,No Signal,17637.84375
2024-01-24 17:30:00+00:00,5,27,-22,No Signal,17632.314453125
2024-01-24 18:30:00+00:00,5,11,-6,No Signal,17522.87109375
2024-01-24 19:30:00+00:00,6,11,-5,No Signal,17492.828125
2024-01-24 20:30:00+00:00,9,10,-1,No Signal,17498.36328125
2024-01-25 14:30:00+00:00,14,22,-8,No Signal,17610.228515625
2024-01-25 15:30:00+00:00,9,24,-15,No Signal,17605.228515625
2024-01-25 16:30:00+00:00,10,21,-11,No Signal,17560.02734375
2024-01-25 17:30:00+00:00,11,15,-4,No Signal,17509.890625
2024-01-25 18:30:00+00:00,13,11,2,No Signal,17457.4453125
2024-01-25 19:30:00+00:00,14,11,3,No Signal,17480.6015625
2024-01-25 20:30:00+00:00,14,13,1,No Signal,17519.72265625
2024-01-26 14:30:00+00:00,23,3,20,Long,17466.572265625
2024-01-26 15:30:00+00:00,21,8,13,No Signal,17497.716796875
2024-01-26 16:30:00+00:00,22,7,15,No Signal,17486.4765625
2024-01-26 17:30:00+00:00,24,7,17,No Signal,17427.76171875
2024-01-26 18:30:00+00:00,20,7,13,No Signal,17416.33984375
2024-01-26 19:30:00+00:00,16,16,0,No Signal,17425.80859375
2024-01-26 20:30:00+00:00,20,14,6,No Signal,17417.169921875
2024-01-29 14:30:00+00:00,23,9,14,No Signal,17435.142578125
2024-01-29 15:30:00+00:00,22,13,9,No Signal,17448.236328125
2024-01-29 16:30:00+00:00,16,16,0,No Signal,17482.767578125
2024-01-29 17:30:00+00:00,16,17,-1,No Signal,17485.390625
2024-01-29 18:30:00+00:00,14,22,-8,No Signal,17507.01171875
2024-01-29 19:30:00+00:00,10,31,-21,Short,17592.26171875
2024-01-29 20:30:00+00:00,10,23,-13,No Signal,17596.3984375
2024-01-30 14:30:00+00:00,8,16,-8,No Signal,17546.455078125
2024-01-30 15:30:00+00:00,6,13,-7,No Signal,17533.375
2024-01-30 16:30:00+00:00,7,10,-3,No Signal,17477.744140625
2024-01-30 17:30:00+00:00,7,13,-6,No Signal,17488.482421875
2024-01-30 18:30:00+00:00,8,18,-10,No Signal,17475.544921875
2024-01-30 19:30:00+00:00,8,17,-9,No Signal,17492.37109375
2024-01-30 20:30:00+00:00,7,19,-12,No Signal,17478.462890625
2024-01-31 14:30:00+00:00,17,11,6,No Signal,17222.779296875
2024-01-31 15:30:00+00:00,14,6,8,No Signal,17229.890625
2024-01-31 16:30:00+00:00,14,4,10,Long,17253.27734375
2024-01-31 17:30:00+00:00,11,5,6,No Signal,17273.05078125
2024-01-31 18:30:00+00:00,19,1,18,No Signal,17228.9296875
2024-01-31 19:30:00+00:00,34,0,34,No Signal,17195.19140625
2024-01-31 20:30:00+00:00,41,1,40,No Signal,17137.7734375
2024-02-01 14:30:00+00:00,23,3,20,No Signal,17268.888671875
2024-02-01 15:30:00+00:00,28,1,27,No Signal,17185.767578125
2024-02-01 16:30:00+00:00,12,3,9,No Signal,17251.173828125
2024-02-01 17:30:00+00:00,12,4,8,No Signal,17275.21875
2024-02-01 18:30:00+00:00,8,4,4,No Signal,17299.8984375
2024-02-01 19:30:00+00:00,11,4,7,No Signal,17343.716796875
2024-02-01 20:30:00+00:00,9,4,5,No Signal,17342.9140625
2024-02-02 14:30:00+00:00,17,18,-1,No Signal,17491.517578125
2024-02-02 15:30:00+00:00,13,20,-7,No Signal,17579.384765625
2024-02-02 16:30:00+00:00,15,19,-4,No Signal,17654.94921875
2024-02-02 17:30:00+00:00,14,16,-2,No Signal,17614.982421875
2024-02-02 18:30:00+00:00,12,25,-13,Short,17655.048828125
2024-02-02 19:30:00+00:00,6,31,-25,No Signal,17671.615234375
2024-02-02 20:30:00+00:00,7,31,-24,No Signal,17640.16015625
2024-02-05 14:30:00+00:00,7,12,-5,No Signal,17536.99609375
2024-02-05 15:30:00+00:00,6,19,-13,No Signal,17524.564453125
2024-02-05 16:30:00+00:00,8,17,-9,No Signal,17598.216796875
2024-02-05 17:30:00+00:00,11,16,-5,No Signal,17595.4375
2024-02-05 18:30:00+00:00,11,19,-8,No Signal,17622.689453125
2024-02-05 19:30:00+00:00,9,17,-8,No Signal,17623.576171875
2024-02-05 20:30:00+00:00,13,16,-3,No Signal,17607.322265625
2024-02-06 14:30:00+00:00,8,15,-7,No Signal,17535.443359375
2024-02-06 15:30:00+00:00,10,14,-4,No Signal,17566.90234375
2024-02-06 16:30:00+00:00,14,13,1,No Signal,17514.076171875
2024-02-06 17:30:00+00:00,10,12,-2,No Signal,17519.2890625
2024-02-06 18:30:00+00:00,19,11,8,No Signal,17507.818359375
2024-02-06 19:30:00+00:00,17,10,7,No Signal,17547.990234375
2024-02-06 20:30:00+00:00,9,15,-6,No Signal,17571.6640625
2024-02-07 14:30:00+00:00,2,38,-36,No Signal,17774.826171875
2024-02-07 15:30:00+00:00,4,33,-29,No Signal,17739.283203125
2024-02-07 16:30:00+00:00,4,30,-26,No Signal,17734.369140625
2024-02-07 17:30:00+00:00,5,29,-24,No Signal,17758.091796875
2024-02-07 18:30:00+00:00,5,27,-22,No Signal,17752.171875
2024-02-07 19:30:00+00:00,5,23,-18,No Signal,17766.5
2024-02-07 20:30:00+00:00,4,25,-21,No Signal,17753.52734375
2024-02-08 14:30:00+00:00,8,23,-15,No Signal,17760.2421875
2024-02-08 15:30:00+00:00,11,23,-12,No Signal,17782.494140625
2024-02-08 16:30:00+00:00,13,32,-19,No Signal,17811.072265625
2024-02-08 17:30:00+00:00,13,33,-20,No Signal,17800.681640625
2024-02-08 18:30:00+00:00,10,33,-23,No Signal,17763.875
2024-02-08 19:30:00+00:00,11,31,-20,No Signal,17792.26953125
2024-02-08 20:30:00+00:00,9,24,-15,No Signal,17784.33984375
2024-02-09 14:30:00+00:00,13,20,-7,No Signal,17891.146484375
2024-02-09 15:30:00+00:00,14,23,-9,No Signal,17902.619140625
2024-02-09 16:30:00+00:00,12,28,-16,No Signal,17920.04296875
2024-02-09 17:30:00+00:00,11,27,-16,No Signal,17953.548828125
2024-02-09 18:30:00+00:00,9,26,-17,No Signal,17968.55859375
2024-02-09 19:30:00+00:00,6,27,-21,No Signal,17960.853515625
2024-02-09 20:30:00+00:00,4,26,-22,No Signal,17958.60546875
2024-02-12 14:30:00+00:00,6,17,-11,No Signal,17957.353515625
2024-02-12 15:30:00+00:00,3,26,-23,No Signal,18013.8203125
2024-02-12 16:30:00+00:00,3,26,-23,No Signal,18001.3671875
2024-02-12 17:30:00+00:00,8,28,-20,No Signal,17980.0625
2024-02-12 18:30:00+00:00,8,24,-16,No Signal,17899.98828125
2024-02-12 19:30:00+00:00,6,19,-13,No Signal,17897.333984375
2024-02-12 20:30:00+00:00,4,20,-16,No Signal,17885.044921875
2024-02-13 14:30:00+00:00,29,4,25,Long,17665.5390625
2024-02-13 15:30:00+00:00,24,2,22,No Signal,17681.263671875
2024-02-13 16:30:00+00:00,33,3,30,No Signal,17620.25
2024-02-13 17:30:00+00:00,40,2,38,No Signal,17613.9140625
2024-02-13 18:30:00+00:00,49,1,48,No Signal,17545.009765625
2024-02-13 19:30:00+00:00,48,3,45,No Signal,17501.970703125
2024-02-13 20:30:00+00:00,35,2,33,No Signal,17603.02734375
2024-02-14 14:30:00+00:00,17,1,16,No Signal,17762.62890625
2024-02-14 15:30:00+00:00,22,2,20,No Signal,17678.822265625
2024-02-14 16:30:00+00:00,22,1,21,No Signal,17686.408203125
2024-02-14 17:30:00+00:00,19,4,15,No Signal,17685.8515625
2024-02-14 18:30:00+00:00,18,2,16,No Signal,17705.498046875
2024-02-14 19:30:00+00:00,12,5,7,No Signal,17764.6015625
2024-02-14 20:30:00+00:00,10,5,5,No Signal,17806.37109375
2024-02-15 14:30:00+00:00,2,23,-21,Short,17756.03515625
2024-02-15 15:30:00+00:00,3,22,-19,No Signal,17765.267578125
2024-02-15 16:30:00+00:00,1,29,-28,No Signal,17801.6953125
2024-02-15 17:30:00+00:00,0,35,-35,No Signal,17853.626953125
2024-02-15 18:30:00+00:00,0,50,-50,No Signal,17841.564453125
2024-02-15 19:30:00+00:00,0,49,-49,No Signal,17829.533203125
2024-02-15 20:30:00+00:00,1,41,-40,No Signal,17847.68359375
2024-02-16 14:30:00+00:00,12,24,-12,No Signal,17706.544921875
2024-02-16 15:30:00+00:00,3,36,-33,No Signal,17802.328125
2024-02-16 16:30:00+00:00,3,37,-34,No Signal,17816.251953125
2024-02-16 17:30:00+00:00,6,32,-26,No Signal,17771.583984375
2024-02-16 18:30:00+00:00,4,31,-27,No Signal,17825.611328125
2024-02-16 19:30:00+00:00,9,13,-4,No Signal,17726.76953125
2024-02-16 20:30:00+00:00,11,14,-3,No Signal,17683.689453125
2024-02-20 14:30:00+00:00,20,6,14,Long,17450.177734375
2024-02-20 15:30:00+00:00,12,6,6,No Signal,17513.453125
2024-02-20 16:30:00+00:00,24,4,20,No Signal,17416.3046875
2024-02-20 17:30:00+00:00,26,5,21,No Signal,17436.431640625
2024-02-20 18:30:00+00:00,20,4,16,No Signal,17478.517578125
2024-02-20 19:30:00+00:00,17,5,12,No Signal,17527.431640625
2024-02-20 20:30:00+00:00,17,4,13,No Signal,17550.767578125
2024-02-21 14:30:00+00:00,20,5,15,No Signal,17419.56640625
2024-02-21 15:30:00+00:00,32,4,28,No Signal,17432.408203125
2024-02-21 16:30:00+00:00,33,3,30,No Signal,17391.470703125
2024-02-21 17:30:00+00:00,29,2,27,No Signal,17397.685546875
2024-02-21 18:30:00+00:00,40,1,39,No Signal,17355.7421875
2024-02-21 19:30:00+00:00,22,3,19,No Signal,17359.853515625
2024-02-21 20:30:00+00:00,12,6,6,No Signal,17478.224609375
2024-02-22 14:30:00+00:00,6,27,-21,Short,17902.2109375
2024-02-22 15:30:00+00:00,5,25,-20,No Signal,17905.130859375
2024-02-22 16:30:00+00:00,3,42,-39,No Signal,17938.84375
2024-02-22 17:30:00+00:00,2,45,-43,No Signal,17971.494140625
2024-02-22 18:30:00+00:00,1,46,-45,No Signal,18033.69140625
2024-02-22 19:30:00+00:00,3,40,-37,No Signal,18008.150390625
2024-02-22 20:30:00+00:00,4,33,-29,No Signal,17998.548828125
2024-02-23 14:30:00+00:00,3,47,-44,No Signal,18002.251953125
2024-02-23 15:30:00+00:00,2,40,-38,No Signal,17959.748046875
2024-02-23 16:30:00+00:00,1,44,-43,No Signal,17972.6796875
2024-02-23 17:30:00+00:00,3,49,-46,No Signal,18004.15234375
2024-02-23 18:30:00+00:00,2,47,-45,No Signal,17947.837890625
2024-02-23 19:30:00+00:00,2,45,-43,No Signal,17925.29296875
2024-02-23 20:30:00+00:00,4,38,-34,No Signal,17937.283203125
2024-02-26 14:30:00+00:00,5,22,-17,No Signal,17976.5
2024-02-26 15:30:00+00:00,6,21,-15,No Signal,17971.544921875
2024-02-26 16:30:00+00:00,11,21,-10,No Signal,18004.76171875
2024-02-26 17:30:00+00:00,11,12,-1,No Signal,17955.23828125
2024-02-26 18:30:00+00:00,17,12,5,No Signal,17985.265625
2024-02-26 19:30:00+00:00,12,14,-2,No Signal,17968.466796875
2024-02-26 20:30:00+00:00,10,11,-1,No Signal,17931.814453125
2024-02-27 14:30:00+00:00,16,18,-2,No Signal,17966.462890625
2024-02-27 15:30:00+00:00,17,15,2,No Signal,17934.923828125
2024-02-27 16:30:00+00:00,14,10,4,No Signal,17933.0546875
2024-02-27 17:30:00+00:00,22,7,15,Long,17900.87890625
2024-02-27 18:30:00+00:00,16,17,-1,No Signal,17962.25
2024-02-27 19:30:00+00:00,15,17,-2,No Signal,17981.203125
2024-02-27 20:30:00+00:00,12,14,-2,No Signal,17974.4765625
2024-02-28 14:30:00+00:00,17,8,9,No Signal,17859.896484375
2024-02-28 15:30:00+00:00,11,10,1,No Signal,17918.21875
2024-02-28 16:30:00+00:00,15,11,4,No Signal,17891.57421875
2024-02-28 17:30:00+00:00,7,11,-4,No Signal,17897.55859375
2024-02-28 18:30:00+00:00,17,9,8,No Signal,17870.328125
2024-02-28 19:30:00+00:00,12,7,5,No Signal,17885.083984375
2024-02-28 20:30:00+00:00,10,11,-1,No Signal,17876.806640625
2024-02-29 14:30:00+00:00,11,8,3,No Signal,17979.080078125
2024-02-29 15:30:00+00:00,11,8,3,No Signal,17942.5625
2024-02-29 16:30:00+00:00,11,7,4,No Signal,17933.919921875
2024-02-29 17:30:00+00:00,9,12,-3,No Signal,18004.626953125
2024-02-29 18:30:00+00:00,13,8,5,No Signal,17987.1328125
2024-02-29 19:30:00+00:00,14,9,5,No Signal,18009.00390625
2024-02-29 20:30:00+00:00,15,9,6,No Signal,18038.927734375
2024-03-01 14:30:00+00:00,7,30,-23,Short,18143.857421875
2024-03-01 15:30:00+00:00,9,30,-21,No Signal,18193.1796875
2024-03-01 16:30:00+00:00,4,33,-29,No Signal,18228.60546875
2024-03-01 17:30:00+00:00,6,33,-27,No Signal,18279.6484375
2024-03-01 18:30:00+00:00,3,36,-33,No Signal,18329.59375
2024-03-01 19:30:00+00:00,3,34,-31,No Signal,18307.021484375
2024-03-01 20:30:00+00:00,4,33,-29,No Signal,18304.80859375
2024-03-04 14:30:00+00:00,17,33,-16,No Signal,18255.701171875
2024-03-04 15:30:00+00:00,13,31,-18,No Signal,18271.318359375
2024-03-04 16:30:00+00:00,14,34,-20,No Signal,18289.521484375
2024-03-04 17:30:00+00:00,16,29,-13,No Signal,18253.892578125
2024-03-04 18:30:00+00:00,17,27,-10,No Signal,18268.67578125
2024-03-04 19:30:00+00:00,14,30,-16,No Signal,18288.708984375
2024-03-04 20:30:00+00:00,15,25,-10,No Signal,18227.9453125
2024-03-05 14:30:00+00:00,28,11,17,Long,17931.23046875
2024-03-05 15:30:00+00:00,30,10,20,No Signal,17926.890625
2024-03-05 16:30:00+00:00,31,7,24,No Signal,17945.298828125
2024-03-05 17:30:00+00:00,36,8,28,No Signal,17893.884765625
2024-03-05 18:30:00+00:00,48,4,44,No Signal,17867.765625
2024-03-05 19:30:00+00:00,49,3,46,No Signal,17810.1015625
2024-03-05 20:30:00+00:00,37,3,34,No Signal,17898.28125
2024-03-06 14:30:00+00:00,23,5,18,No Signal,17990.166015625
2024-03-06 15:30:00+00:00,18,7,11,No Signal,18067.515625
2024-03-06 16:30:00+00:00,15,6,9,No Signal,18127.5
2024-03-06 17:30:00+00:00,11,7,4,No Signal,18123.962890625
2024-03-06 18:30:00+00:00,15,7,8,No Signal,18048.5703125
2024-03-06 19:30:00+00:00,19,5,14,No Signal,17989.41796875
2024-03-06 20:30:00+00:00,16,6,10,No Signal,18015.8046875
2024-03-07 14:30:00+00:00,4,20,-16,Short,18217.009765625
2024-03-07 15:30:00+00:00,3,23,-20,No Signal,18267.60546875
2024-03-07 16:30:00+00:00,3,30,-27,No Signal,18291.015625
2024-03-07 17:30:00+00:00,2,33,-31,No Signal,18306.443359375
2024-03-07 18:30:00+00:00,1,36,-35,No Signal,18319.6484375
2024-03-07 19:30:00+00:00,1,43,-42,No Signal,18282.84765625
2024-03-07 20:30:00+00:00,3,31,-28,No Signal,18301.642578125
2024-03-08 14:30:00+00:00,5,33,-28,No Signal,18408.609375
2024-03-08 15:30:00+00:00,3,14,-11,No Signal,18178.6328125
2024-03-08 16:30:00+00:00,3,13,-10,No Signal,18166.224609375
2024-03-08 17:30:00+00:00,4,8,-4,No Signal,18042.9375
2024-03-08 18:30:00+00:00,3,14,-11,No Signal,18098.640625
2024-03-08 19:30:00+00:00,4,8,-4,No Signal,18036.4609375
2024-03-08 20:30:00+00:00,5,8,-3,No Signal,18020.671875
2024-03-11 13:30:00+00:00,20,12,8,No Signal,17910.8828125
2024-03-11 14:30:00+00:00,25,16,9,No Signal,17914.408203125
2024-03-11 15:30:00+00:00,24,17,7,No Signal,17955.86328125
2024-03-11 16:30:00+00:00,24,18,6,No Signal,17974.060546875
2024-03-11 17:30:00+00:00,21,13,8,No Signal,17974.916015625
2024-03-11 18:30:00+00:00,19,13,6,No Signal,17942.0546875
2024-03-11 19:30:00+00:00,17,16,1,No Signal,17953.337890625
2024-03-12 13:30:00+00:00,15,13,2,No Signal,18105.080078125
2024-03-12 14:30:00+00:00,8,13,-5,No Signal,18193.142578125
2024-03-12 15:30:00+00:00,13,10,3,No Signal,18124.39453125
2024-03-12 16:30:00+00:00,7,15,-8,No Signal,18122.9453125
2024-03-12 17:30:00+00:00,5,16,-11,No Signal,18179.466796875
2024-03-12 18:30:00+00:00,4,23,-19,No Signal,18206.173828125
2024-03-12 19:30:00+00:00,5,22,-17,No Signal,18217.638671875
2024-03-13 13:30:00+00:00,2,24,-22,No Signal,18092.4765625
2024-03-13 14:30:00+00:00,2,21,-19,No Signal,18065.73828125
2024-03-13 15:30:00+00:00,5,20,-15,No Signal,18075.533203125
2024-03-13 16:30:00+00:00,4,22,-18,No Signal,18122.169921875
2024-03-13 17:30:00+00:00,7,19,-12,No Signal,18123.474609375
2024-03-13 18:30:00+00:00,9,13,-4,No Signal,18056.12890625
2024-03-13 19:30:00+00:00,11,12,-1,No Signal,18068.328125
2024-03-14 13:30:00+00:00,22,7,15,Long,18062.015625
2024-03-14 14:30:00+00:00,25,7,18,No Signal,18026.189453125
2024-03-14 15:30:00+00:00,17,8,9,No Signal,18029.384765625
2024-03-14 16:30:00+00:00,22,8,14,No Signal,17985.50390625
2024-03-14 17:30:00+00:00,24,7,17,No Signal,18048.96875
2024-03-14 18:30:00+00:00,33,6,27,No Signal,17943.6875
2024-03-14 19:30:00+00:00,19,7,12,No Signal,18020.708984375
2024-03-15 13:30:00+00:00,27,1,26,No Signal,17863.5625
2024-03-15 14:30:00+00:00,22,3,19,No Signal,17857.44140625
2024-03-15 15:30:00+00:00,28,2,26,No Signal,17794.93359375
2024-03-15 16:30:00+00:00,32,1,31,No Signal,17806.2421875
2024-03-15 17:30:00+00:00,34,2,32,No Signal,17812.140625
2024-03-15 18:30:00+00:00,22,5,17,No Signal,17842.46875
2024-03-15 19:30:00+00:00,28,5,23,No Signal,17811.337890625
2024-03-18 13:30:00+00:00,7,12,-5,No Signal,18112.517578125
2024-03-18 14:30:00+00:00,4,15,-11,Short,18068.125
2024-03-18 15:30:00+00:00,6,9,-3,No Signal,18043.322265625
2024-03-18 16:30:00+00:00,4,14,-10,No Signal,18035.37890625
2024-03-18 17:30:00+00:00,6,11,-5,No Signal,18057.888671875
2024-03-18 18:30:00+00:00,5,14,-9,No Signal,18033.5390625
2024-03-18 19:30:00+00:00,13,10,3,No Signal,17984.275390625
2024-03-19 13:30:00+00:00,16,11,5,No Signal,17835.296875
2024-03-19 14:30:00+00:00,5,8,-3,No Signal,17885.134765625
2024-03-19 15:30:00+00:00,1,13,-12,No Signal,17952.982421875
2024-03-19 16:30:00+00:00,2,16,-14,No Signal,18005.828125
2024-03-19 17:30:00+00:00,0,14,-14,No Signal,18022.447265625
2024-03-19 18:30:00+00:00,3,10,-7,No Signal,17987.505859375
2024-03-19 19:30:00+00:00,1,14,-13,No Signal,18028.546875
2024-03-20 13:30:00+00:00,11,11,0,No Signal,18052.169921875
2024-03-20 14:30:00+00:00,8,7,1,No Signal,18044.748046875
2024-03-20 15:30:00+00:00,6,6,0,No Signal,18036.73046875
2024-03-20 16:30:00+00:00,9,3,6,No Signal,18021.076171875
2024-03-20 17:30:00+00:00,2,10,-8,No Signal,18121.919921875
2024-03-20 18:30:00+00:00,1,17,-16,No Signal,18236.73046875
2024-03-20 19:30:00+00:00,1,20,-19,No Signal,18238.60546875
2024-03-21 13:30:00+00:00,2,56,-54,No Signal,18420.41015625
2024-03-21 14:30:00+00:00,0,48,-48,No Signal,18415.796875
2024-03-21 15:30:00+00:00,0,45,-45,No Signal,18461.83984375
2024-03-21 16:30:00+00:00,1,39,-38,No Signal,18424.4609375
2024-03-21 17:30:00+00:00,1,36,-35,No Signal,18375.244140625
2024-03-21 18:30:00+00:00,1,39,-38,No Signal,18347.455078125
2024-03-21 19:30:00+00:00,2,30,-28,No Signal,18317.095703125
2024-03-22 13:30:00+00:00,3,24,-21,No Signal,18296.77734375
2024-03-22 14:30:00+00:00,4,22,-18,No Signal,18317.251953125
2024-03-22 15:30:00+00:00,3,18,-15,No Signal,18316.58203125
2024-03-22 16:30:00+00:00,4,25,-21,No Signal,18360.201171875
2024-03-22 17:30:00+00:00,8,15,-7,No Signal,18372.673828125
2024-03-22 18:30:00+00:00,13,7,6,No Signal,18335.158203125
2024-03-22 19:30:00+00:00,11,6,5,No Signal,18339.91015625
2024-03-25 13:30:00+00:00,28,4,24,Long,18280.6796875
2024-03-25 14:30:00+00:00,26,4,22,No Signal,18296.8046875
2024-03-25 15:30:00+00:00,33,2,31,No Signal,18293.072265625
2024-03-25 16:30:00+00:00,25,3,22,No Signal,18312.787109375
2024-03-25 17:30:00+00:00,23,7,16,No Signal,18327.669921875
2024-03-25 18:30:00+00:00,21,7,14,No Signal,18299.34375
2024-03-25 19:30:00+00:00,23,6,17,No Signal,18279.0703125
2024-03-26 13:30:00+00:00,8,8,0,No Signal,18330.900390625
2024-03-26 14:30:00+00:00,10,11,-1,No Signal,18340.228515625
2024-03-26 15:30:00+00:00,7,11,-4,No Signal,18333.080078125
2024-03-26 16:30:00+00:00,19,11,8,No Signal,18320.82421875
2024-03-26 17:30:00+00:00,17,7,10,No Signal,18329.015625
2024-03-26 18:30:00+00:00,17,9,8,No Signal,18281.2578125
2024-03-26 19:30:00+00:00,19,5,14,No Signal,18213.693359375
2024-03-27 13:30:00+00:00,11,15,-4,No Signal,18193.673828125
2024-03-27 14:30:00+00:00,10,11,-1,No Signal,18183.72265625
2024-03-27 15:30:00+00:00,10,12,-2,No Signal,18213.830078125
2024-03-27 16:30:00+00:00,10,13,-3,No Signal,18206.70703125
2024-03-27 17:30:00+00:00,7,13,-6,No Signal,18232.166015625
2024-03-27 18:30:00+00:00,8,12,-4,No Signal,18211.09765625
2024-03-27 19:30:00+00:00,2,16,-14,Short,18283.41796875
2024-03-28 13:30:00+00:00,11,24,-13,No Signal,18265.875
2024-03-28 14:30:00+00:00,7,26,-19,No Signal,18279.177734375
2024-03-28 15:30:00+00:00,8,24,-16,No Signal,18264.064453125
2024-03-28 16:30:00+00:00,8,22,-14,No Signal,18243.32421875
2024-03-28 17:30:00+00:00,10,22,-12,No Signal,18254.98046875
2024-03-28 18:30:00+00:00,7,24,-17,No Signal,18280.951171875
2024-03-28 19:30:00+00:00,5,21,-16,No Signal,18242.978515625
2024-04-01 13:30:00+00:00,7,17,-10,No Signal,18324.64453125
2024-04-01 14:30:00+00:00,8,13,-5,No Signal,18261.2890625
2024-04-01 15:30:00+00:00,14,14,0,No Signal,18264.744140625
2024-04-01 16:30:00+00:00,14,11,3,No Signal,18240.4921875
2024-04-01 17:30:00+00:00,13,8,5,No Signal,18261.529296875
2024-04-01 18:30:00+00:00,12,8,4,No Signal,18259.0625
2024-04-01 19:30:00+00:00,15,7,8,No Signal,18290.732421875
2024-04-02 13:30:00+00:00,43,1,42,Long,18035.234375
2024-04-02 14:30:00+00:00,41,0,41,No Signal,18062.50390625
2024-04-02 15:30:00+00:00,43,1,42,No Signal,18048.259765625
2024-04-02 16:30:00+00:00,39,3,36,No Signal,18075.3125
2024-04-02 17:30:00+00:00,41,1,40,No Signal,18078.107421875
2024-04-02 18:30:00+00:00,39,1,38,No Signal,18098.861328125
2024-04-02 19:30:00+00:00,37,4,33,No Signal,18122.087890625
2024-04-03 13:30:00+00:00,21,2,19,No Signal,18201.048828125
2024-04-03 14:30:00+00:00,17,3,14,No Signal,18232.693359375
2024-04-03 15:30:00+00:00,17,4,13,No Signal,18213.859375
2024-04-03 16:30:00+00:00,19,5,14,No Signal,18212.84765625
2024-04-03 17:30:00+00:00,18,6,12,No Signal,18202.1640625
2024-04-03 18:30:00+00:00,24,4,20,No Signal,18126.587890625
2024-04-03 19:30:00+00:00,24,4,20,No Signal,18161.2109375
2024-04-04 13:30:00+00:00,8,27,-19,Short,18306.26171875
2024-04-04 14:30:00+00:00,11,21,-10,No Signal,18297.498046875
2024-04-04 15:30:00+00:00,9,27,-18,No Signal,18349.41015625
2024-04-04 16:30:00+00:00,8,29,-21,No Signal,18338.4375
2024-04-04 17:30:00+00:00,14,5,9,No Signal,18138.267578125
2024-04-04 18:30:00+00:00,25,0,25,Long,17915.78515625
2024-04-04 19:30:00+00:00,29,0,29,No Signal,17876.177734375
2024-04-05 13:30:00+00:00,23,0,23,No Signal,18008.33203125
2024-04-05 14:30:00+00:00,13,0,13,No Signal,18082.318359375
2024-04-05 15:30:00+00:00,8,1,7,No Signal,18157.64453125
2024-04-05 16:30:00+00:00,9,1,8,No Signal,18166.87890625
2024-04-05 17:30:00+00:00,8,0,8,No Signal,18087.740234375
2024-04-05 18:30:00+00:00,5,0,5,No Signal,18092.244140625
2024-04-05 19:30:00+00:00,8,0,8,No Signal,18105.875
2024-04-08 13:30:00+00:00,17,0,17,No Signal,18146.279296875
2024-04-08 14:30:00+00:00,9,0,9,No Signal,18141.291015625
2024-04-08 15:30:00+00:00,16,0,16,No Signal,18089.51171875
2024-04-08 16:30:00+00:00,12,0,12,No Signal,18114.73828125
2024-04-08 17:30:00+00:00,3,6,-3,No Signal,18121.732421875
2024-04-08 18:30:00+00:00,2,24,-22,Short,18119.55078125
2024-04-08 19:30:00+00:00,3,28,-25,No Signal,18103.05078125
2024-04-09 13:30:00+00:00,5,31,-26,No Signal,18091.865234375
2024-04-09 14:30:00+00:00,15,21,-6,No Signal,18035.490234375
2024-04-09 15:30:00+00:00,13,18,-5,No Signal,18095.2265625
2024-04-09 16:30:00+00:00,13,16,-3,No Signal,18085.431640625
2024-04-09 17:30:00+00:00,8,24,-16,No Signal,18070.490234375
2024-04-09 18:30:00+00:00,7,28,-21,No Signal,18132.828125
2024-04-09 19:30:00+00:00,6,32,-26,No Signal,18170.83984375
2024-04-10 13:30:00+00:00,10,4,6,No Signal,17996.951171875
2024-04-10 14:30:00+00:00,15,1,14,Long,17992.625
2024-04-10 15:30:00+00:00,17,1,16,No Signal,17965.037109375
2024-04-10 16:30:00+00:00,16,1,15,No Signal,17997.09765625
2024-04-10 17:30:00+00:00,22,2,20,No Signal,17961.80078125
2024-04-10 18:30:00+00:00,9,4,5,No Signal,18000.46484375
2024-04-10 19:30:00+00:00,11,5,6,No Signal,18010.08203125
2024-04-11 13:30:00+00:00,26,2,24,No Signal,18034.7265625
2024-04-11 14:30:00+00:00,19,5,14,No Signal,18071.505859375
2024-04-11 15:30:00+00:00,18,3,15,No Signal,18120.93359375
2024-04-11 16:30:00+00:00,7,8,-1,No Signal,18233.236328125
2024-04-11 17:30:00+00:00,4,19,-15,Short,18312.8984375
2024-04-11 18:30:00+00:00,8,17,-9,No Signal,18322.130859375
2024-04-11 19:30:00+00:00,12,13,-1,No Signal,18306.98046875
2024-04-12 13:30:00+00:00,14,10,4,No Signal,18105.65234375
2024-04-12 14:30:00+00:00,10,7,3,No Signal,18089.904296875
2024-04-12 15:30:00+00:00,12,6,6,No Signal,18032.884765625
2024-04-12 16:30:00+00:00,20,2,18,Long,17965.6875
2024-04-12 17:30:00+00:00,12,3,9,No Signal,17996.564453125
2024-04-12 18:30:00+00:00,17,2,15,No Signal,17966.84765625
2024-04-12 19:30:00+00:00,11,4,7,No Signal,18005.95703125
2024-04-15 13:30:00+00:00,13,3,10,No Signal,18056.49609375
2024-04-15 14:30:00+00:00,13,3,10,No Signal,18023.2421875
2024-04-15 15:30:00+00:00,19,2,17,No Signal,17966.623046875
2024-04-15 16:30:00+00:00,51,0,51,No Signal,17786.443359375
2024-04-15 17:30:00+00:00,75,0,75,No Signal,17731.365234375
2024-04-15 18:30:00+00:00,74,3,71,No Signal,17693.51171875
2024-04-15 19:30:00+00:00,66,1,65,No Signal,17707.810546875
2024-04-16 13:30:00+00:00,47,2,45,No Signal,17700.890625
2024-04-16 14:30:00+00:00,33,1,32,No Signal,17745.1953125
2024-04-16 15:30:00+00:00,26,0,26,No Signal,17734.9921875
2024-04-16 16:30:00+00:00,21,1,20,No Signal,17734.2421875
2024-04-16 17:30:00+00:00,32,2,30,No Signal,17694.53125
2024-04-16 18:30:00+00:00,17,1,16,No Signal,17779.6796875
2024-04-16 19:30:00+00:00,27,1,26,No Signal,17711.689453125
2024-04-17 13:30:00+00:00,29,0,29,No Signal,17688.765625
2024-04-17 14:30:00+00:00,39,0,39,No Signal,17615.798828125
2024-04-17 15:30:00+00:00,44,1,43,No Signal,17523.78125
2024-04-17 16:30:00+00:00,13,3,10,No Signal,17549.05859375
2024-04-17 17:30:00+00:00,8,8,0,No Signal,17553.375
2024-04-17 18:30:00+00:00,11,6,5,No Signal,17494.330078125
2024-04-17 19:30:00+00:00,16,8,8,No Signal,17491.158203125
2024-04-18 13:30:00+00:00,18,12,6,No Signal,17506.232421875
2024-04-18 14:30:00+00:00,20,10,10,No Signal,17555.89453125
2024-04-18 15:30:00+00:00,25,9,16,No Signal,17533.25390625
2024-04-18 16:30:00+00:00,30,9,21,No Signal,17437.412109375
2024-04-18 17:30:00+00:00,25,9,16,No Signal,17412.2578125
2024-04-18 18:30:00+00:00,34,8,26,No Signal,17410.544921875
2024-04-18 19:30:00+00:00,30,10,20,No Signal,17394.107421875
2024-04-19 13:30:00+00:00,34,9,25,No Signal,17220.98046875
2024-04-19 14:30:00+00:00,34,10,24,No Signal,17186.544921875
2024-04-19 15:30:00+00:00,38,8,30,No Signal,17064.099609375
2024-04-19 16:30:00+00:00,33,10,23,No Signal,17118.74609375
2024-04-19 17:30:00+00:00,36,10,26,No Signal,17071.2578125
2024-04-19 18:30:00+00:00,33,11,22,No Signal,17038.78515625
2024-04-19 19:30:00+00:00,33,11,22,No Signal,17038.07421875
2024-04-22 13:30:00+00:00,30,13,17,No Signal,17049.466796875
2024-04-22 14:30:00+00:00,43,11,32,No Signal,17062.19140625
2024-04-22 15:30:00+00:00,31,13,18,No Signal,17118.34765625
2024-04-22 16:30:00+00:00,13,23,-10,Short,17199.375
2024-04-22 17:30:00+00:00,2,27,-25,No Signal,17286.279296875
2024-04-22 18:30:00+00:00,5,20,-15,No Signal,17249.48046875
2024-04-22 19:30:00+00:00,6,18,-12,No Signal,17212.7890625
2024-04-23 13:30:00+00:00,0,22,-22,No Signal,17425.779296875
2024-04-23 14:30:00+00:00,0,37,-37,No Signal,17449.8671875
2024-04-23 15:30:00+00:00,0,51,-51,No Signal,17465.490234375
2024-04-23 16:30:00+00:00,0,44,-44,No Signal,17458.103515625
2024-04-23 17:30:00+00:00,0,58,-58,No Signal,17507.7890625
2024-04-23 18:30:00+00:00,0,56,-56,No Signal,17487.265625
2024-04-23 19:30:00+00:00,0,54,-54,No Signal,17471.734375
2024-04-24 13:30:00+00:00,3,54,-51,No Signal,17590.8203125
2024-04-24 14:30:00+00:00,1,48,-47,No Signal,17520.859375
2024-04-24 15:30:00+00:00,0,37,-37,No Signal,17470.029296875
2024-04-24 16:30:00+00:00,1,31,-30,No Signal,17515.267578125
2024-04-24 17:30:00+00:00,1,25,-24,No Signal,17502.8671875
2024-04-24 18:30:00+00:00,0,33,-33,No Signal,17533.265625
2024-04-24 19:30:00+00:00,1,34,-33,No Signal,17528.6328125
2024-04-25 13:30:00+00:00,19,10,9,No Signal,17306.912109375
2024-04-25 14:30:00+00:00,19,8,11,Long,17278.408203125
2024-04-25 15:30:00+00:00,15,8,7,No Signal,17333.619140625
2024-04-25 16:30:00+00:00,13,10,3,No Signal,17366.728515625
2024-04-25 17:30:00+00:00,11,8,3,No Signal,17390.55078125
2024-04-25 18:30:00+00:00,9,14,-5,No Signal,17468.947265625
2024-04-25 19:30:00+00:00,6,13,-7,No Signal,17431.896484375
2024-04-26 13:30:00+00:00,9,14,-5,No Signal,17675.447265625
2024-04-26 14:30:00+00:00,10,19,-9,No Signal,17709.611328125
2024-04-26 15:30:00+00:00,10,22,-12,Short,17718.58203125
2024-04-26 16:30:00+00:00,10,24,-14,No Signal,17763.23046875
2024-04-26 17:30:00+00:00,9,22,-13,No Signal,17721.033203125
2024-04-26 18:30:00+00:00,9,21,-12,No Signal,17759.115234375
2024-04-26 19:30:00+00:00,10,21,-11,No Signal,17712.13671875
2024-04-29 13:30:00+00:00,5,39,-34,No Signal,17771.32421875
2024-04-29 14:30:00+00:00,6,38,-32,No Signal,17754.185546875
2024-04-29 15:30:00+00:00,9,38,-29,No Signal,17780.45703125
2024-04-29 16:30:00+00:00,6,34,-28,No Signal,17799.0703125
2024-04-29 17:30:00+00:00,8,32,-24,No Signal,17763.208984375
2024-04-29 18:30:00+00:00,8,21,-13,No Signal,17722.921875
2024-04-29 19:30:00+00:00,8,30,-22,No Signal,17783.92578125
2024-04-30 13:30:00+00:00,13,10,3,No Signal,17710.958984375
2024-04-30 14:30:00+00:00,19,11,8,No Signal,17649.126953125
2024-04-30 15:30:00+00:00,20,7,13,Long,17643.673828125
2024-04-30 16:30:00+00:00,31,6,25,No Signal,17578.48046875
2024-04-30 17:30:00+00:00,29,6,23,No Signal,17571.431640625
2024-04-30 18:30:00+00:00,31,4,27,No Signal,17569.287109375
2024-04-30 19:30:00+00:00,33,4,29,No Signal,17445.03515625
2024-05-01 13:30:00+00:00,44,2,42,No Signal,17352.2890625
2024-05-01 14:30:00+00:00,44,3,41,No Signal,17336.2734375
2024-05-01 15:30:00+00:00,40,4,36,No Signal,17346.0234375
2024-05-01 16:30:00+00:00,43,4,39,No Signal,17331.23828125
2024-05-01 17:30:00+00:00,28,4,24,No Signal,17443.548828125
2024-05-01 18:30:00+00:00,12,11,1,No Signal,17598.71484375
2024-05-01 19:30:00+00:00,32,2,30,No Signal,17316.3359375
2024-05-02 13:30:00+00:00,21,7,14,No Signal,17390.9296875
2024-05-02 14:30:00+00:00,18,8,10,No Signal,17415.755859375
2024-05-02 15:30:00+00:00,14,8,6,No Signal,17431.380859375
2024-05-02 16:30:00+00:00,8,10,-2,No Signal,17496.134765625
2024-05-02 17:30:00+00:00,8,10,-2,No Signal,17519.115234375
2024-05-02 18:30:00+00:00,7,11,-4,No Signal,17564.244140625
2024-05-02 19:30:00+00:00,9,16,-7,No Signal,17545.359375
2024-05-03 13:30:00+00:00,2,29,-27,Short,17834.09765625
2024-05-03 14:30:00+00:00,3,25,-22,No Signal,17834.30859375
2024-05-03 15:30:00+00:00,3,28,-25,No Signal,17875.404296875
2024-05-03 16:30:00+00:00,3,24,-21,No Signal,17881.845703125
2024-05-03 17:30:00+00:00,4,16,-12,No Signal,17908.9921875
2024-05-03 18:30:00+00:00,8,13,-5,No Signal,17908.107421875
2024-05-03 19:30:00+00:00,5,49,-44,No Signal,17891.279296875
2024-05-06 13:30:00+00:00,3,49,-46,No Signal,17994.79296875
2024-05-06 14:30:00+00:00,3,44,-41,No Signal,17992.583984375
2024-05-06 15:30:00+00:00,4,41,-37,No Signal,17982.09375
2024-05-06 16:30:00+00:00,4,41,-37,No Signal,18005.517578125
2024-05-06 17:30:00+00:00,5,42,-37,No Signal,18038.771484375
2024-05-06 18:30:00+00:00,9,38,-29,No Signal,18035.29296875
2024-05-06 19:30:00+00:00,6,40,-34,No Signal,18093.48046875
2024-05-07 13:30:00+00:00,6,32,-26,No Signal,18083.701171875
2024-05-07 14:30:00+00:00,4,38,-34,No Signal,18139.654296875
2024-05-07 15:30:00+00:00,8,33,-25,No Signal,18150.275390625
2024-05-07 16:30:00+00:00,5,35,-30,No Signal,18147.11328125
2024-05-07 17:30:00+00:00,8,19,-11,No Signal,18079.078125
2024-05-07 18:30:00+00:00,8,22,-14,No Signal,18092.654296875
2024-05-07 19:30:00+00:00,9,20,-11,No Signal,18091.0390625
2024-05-08 13:30:00+00:00,13,15,-2,No Signal,18101.822265625
2024-05-08 14:30:00+00:00,10,18,-8,No Signal,18084.130859375
2024-05-08 15:30:00+00:00,11,15,-4,No Signal,18076.443359375
2024-05-08 16:30:00+00:00,14,10,4,No Signal,18043.08984375
2024-05-08 17:30:00+00:00,12,11,1,No Signal,18081.34765625
2024-05-08 18:30:00+00:00,12,11,1,No Signal,18080.90625
2024-05-08 19:30:00+00:00,15,8,7,No Signal,18084.640625
2024-05-09 13:30:00+00:00,12,9,3,No Signal,18055.005859375
2024-05-09 14:30:00+00:00,11,14,-3,No Signal,18128.826171875
2024-05-09 15:30:00+00:00,13,14,-1,No Signal,18100.087890625
2024-05-09 16:30:00+00:00,12,15,-3,No Signal,18121.9609375
2024-05-09 17:30:00+00:00,11,16,-5,No Signal,18117.6484375
2024-05-09 18:30:00+00:00,11,14,-3,No Signal,18112.318359375
2024-05-09 19:30:00+00:00,10,14,-4,No Signal,18115.751953125
2024-05-10 13:30:00+00:00,3,19,-16,No Signal,18135.546875
2024-05-10 14:30:00+00:00,5,24,-19,No Signal,18142.072265625
2024-05-10 15:30:00+00:00,6,23,-17,No Signal,18138.642578125
2024-05-10 16:30:00+00:00,3,26,-23,No Signal,18129.28515625
2024-05-10 17:30:00+00:00,5,25,-20,No Signal,18152.69140625
2024-05-10 18:30:00+00:00,4,27,-23,No Signal,18161.087890625
2024-05-10 19:30:00+00:00,6,27,-21,No Signal,18158.578125
2024-05-13 13:30:00+00:00,3,31,-28,No Signal,18210.5859375
2024-05-13 14:30:00+00:00,9,22,-13,No Signal,18185.658203125
2024-05-13 15:30:00+00:00,7,20,-13,No Signal,18207.818359375
2024-05-13 16:30:00+00:00,9,17,-8,No Signal,18197.9609375
2024-05-13 17:30:00+00:00,11,18,-7,No Signal,18187.890625
2024-05-13 18:30:00+00:00,10,21,-11,No Signal,18192.439453125
2024-05-13 19:30:00+00:00,9,22,-13,No Signal,18199.72265625
2024-05-14 13:30:00+00:00,8,21,-13,No Signal,18267.70703125
2024-05-14 14:30:00+00:00,10,22,-12,No Signal,18264.22265625
2024-05-14 15:30:00+00:00,13,20,-7,No Signal,18218.064453125
2024-05-14 16:30:00+00:00,15,15,0,No Signal,18227.771484375
2024-05-14 17:30:00+00:00,12,22,-10,No Signal,18283.201171875
2024-05-14 18:30:00+00:00,8,22,-14,No Signal,18323.447265625
2024-05-14 19:30:00+00:00,8,26,-18,No Signal,18319.6953125
2024-05-15 13:30:00+00:00,9,22,-13,No Signal,18436.6640625
2024-05-15 14:30:00+00:00,3,27,-24,No Signal,18498.869140625
2024-05-15 15:30:00+00:00,2,31,-29,No Signal,18512.9765625
2024-05-15 16:30:00+00:00,1,37,-36,No Signal,18556.271484375
2024-05-15 17:30:00+00:00,0,37,-37,No Signal,18585.685546875
2024-05-15 18:30:00+00:00,3,39,-36,No Signal,18597.9765625
2024-05-15 19:30:00+00:00,2,36,-34,No Signal,18599.134765625
2024-05-16 13:30:00+00:00,5,30,-25,No Signal,18627.69140625
2024-05-16 14:30:00+00:00,5,42,-37,No Signal,18656.1015625
2024-05-16 15:30:00+00:00,5,42,-37,No Signal,18634.12890625
2024-05-16 16:30:00+00:00,4,41,-37,No Signal,18599.404296875
2024-05-16 17:30:00+00:00,4,39,-35,No Signal,18586.0625
2024-05-16 18:30:00+00:00,4,36,-32,No Signal,18597.103515625
2024-05-16 19:30:00+00:00,5,31,-26,No Signal,18557.984375
2024-05-17 13:30:00+00:00,5,21,-16,No Signal,18575.970703125
2024-05-17 14:30:00+00:00,8,18,-10,No Signal,18565.576171875
2024-05-17 15:30:00+00:00,10,17,-7,No Signal,18552.525390625
2024-05-17 16:30:00+00:00,15,14,1,No Signal,18534.31640625
2024-05-17 17:30:00+00:00,24,8,16,Long,18484.8515625
2024-05-17 18:30:00+00:00,14,13,1,No Signal,18543.39453125
2024-05-17 19:30:00+00:00,15,13,2,No Signal,18549.359375
2024-05-20 13:30:00+00:00,10,12,-2,No Signal,18663.8671875
2024-05-20 14:30:00+00:00,12,10,2,No Signal,18664.298828125
2024-05-20 15:30:00+00:00,16,8,8,No Signal,18660.98046875
2024-05-20 16:30:00+00:00,14,14,0,No Signal,18659.1640625
2024-05-20 17:30:00+00:00,14,14,0,No Signal,18660.443359375
2024-05-20 18:30:00+00:00,15,14,1,No Signal,18688.86328125
2024-05-20 19:30:00+00:00,14,18,-4,No Signal,18677.9140625
2024-05-21 13:30:00+00:00,17,13,4,No Signal,18646.626953125
2024-05-21 14:30:00+00:00,17,14,3,No Signal,18669.884765625
2024-05-21 15:30:00+00:00,17,15,2,No Signal,18680.076171875
2024-05-21 16:30:00+00:00,17,21,-4,No Signal,18671.15625
2024-05-21 17:30:00+00:00,13,23,-10,Short,18671.896484375
2024-05-21 18:30:00+00:00,15,20,-5,No Signal,18687.861328125
2024-05-21 19:30:00+00:00,14,17,-3,No Signal,18714.744140625
2024-05-22 13:30:00+00:00,18,18,0,No Signal,18735.703125
2024-05-22 14:30:00+00:00,16,19,-3,No Signal,18752.65234375
2024-05-22 15:30:00+00:00,10,21,-11,No Signal,18739.607421875
2024-05-22 16:30:00+00:00,13,21,-8,No Signal,18737.029296875
2024-05-22 17:30:00+00:00,19,12,7,No Signal,18613.458984375
2024-05-22 18:30:00+00:00,21,12,9,No Signal,18656.234375
2024-05-22 19:30:00+00:00,17,13,4,No Signal,18706.8125
2024-05-23 13:30:00+00:00,21,16,5,No Signal,18818.619140625
2024-05-23 14:30:00+00:00,16,14,2,No Signal,18822.125
2024-05-23 15:30:00+00:00,16,15,1,No Signal,18853.54296875
2024-05-23 16:30:00+00:00,20,13,7,No Signal,18775.244140625
2024-05-23 17:30:00+00:00,29,8,21,Long,18612.48046875
2024-05-23 18:30:00+00:00,31,6,25,No Signal,18580.265625
2024-05-23 19:30:00+00:00,33,7,26,No Signal,18625.939453125
2024-05-24 13:30:00+00:00,24,8,16,No Signal,18759.525390625
2024-05-24 14:30:00+00:00,18,9,9,No Signal,18828.931640625
2024-05-24 15:30:00+00:00,16,8,8,No Signal,18834.802734375
2024-05-24 16:30:00+00:00,21,6,15,No Signal,18825.236328125
2024-05-24 17:30:00+00:00,18,10,8,No Signal,18827.4296875
2024-05-24 18:30:00+00:00,21,7,14,No Signal,18792.056640625
2024-05-24 19:30:00+00:00,22,5,17,No Signal,18809.046875
2024-05-28 13:30:00+00:00,23,4,19,No Signal,18829.423828125
2024-05-28 14:30:00+00:00,22,5,17,No Signal,18858.2265625
2024-05-28 15:30:00+00:00,27,5,22,No Signal,18845.908203125
2024-05-28 16:30:00+00:00,26,8,18,No Signal,18856.603515625
2024-05-28 17:30:00+00:00,22,14,8,No Signal,18811.3125
2024-05-28 18:30:00+00:00,22,14,8,No Signal,18811.564453125
2024-05-28 19:30:00+00:00,21,16,5,No Signal,18874.46875
2024-05-29 13:30:00+00:00,37,3,34,No Signal,18787.626953125
2024-05-29 14:30:00+00:00,45,2,43,No Signal,18786.01953125
2024-05-29 15:30:00+00:00,44,2,42,No Signal,18788.484375
2024-05-29 16:30:00+00:00,41,1,40,No Signal,18785.984375
2024-05-29 17:30:00+00:00,38,2,36,No Signal,18777.044921875
2024-05-29 18:30:00+00:00,34,3,31,No Signal,18784.154296875
2024-05-29 19:30:00+00:00,38,2,36,No Signal,18731.55078125
2024-05-30 13:30:00+00:00,29,2,27,No Signal,18659.126953125
2024-05-30 14:30:00+00:00,33,2,31,No Signal,18610.44921875
2024-05-30 15:30:00+00:00,26,2,24,No Signal,18622.068359375
2024-05-30 16:30:00+00:00,27,4,23,No Signal,18651.689453125
2024-05-30 17:30:00+00:00,26,4,22,No Signal,18612.443359375
2024-05-30 18:30:00+00:00,26,4,22,No Signal,18568.349609375
2024-05-30 19:30:00+00:00,34,4,30,No Signal,18537.193359375
2024-05-31 13:30:00+00:00,29,16,13,No Signal,18370.728515625
2024-05-31 14:30:00+00:00,32,15,17,No Signal,18283.6875
2024-05-31 15:30:00+00:00,38,12,26,No Signal,18204.609375
2024-05-31 16:30:00+00:00,33,14,19,No Signal,18303.173828125
2024-05-31 17:30:00+00:00,28,14,14,No Signal,18267.96484375
2024-05-31 18:30:00+00:00,22,15,7,No Signal,18357.15234375
2024-05-31 19:30:00+00:00,10,26,-16,Short,18540.81640625
2024-06-03 13:30:00+00:00,9,24,-15,No Signal,18652.86328125
2024-06-03 14:30:00+00:00,7,20,-13,No Signal,18568.357421875
2024-06-03 15:30:00+00:00,10,13,-3,No Signal,18457.89453125
2024-06-03 16:30:00+00:00,10,9,1,No Signal,18479.810546875
2024-06-03 17:30:00+00:00,8,11,-3,No Signal,18494.45703125
2024-06-03 18:30:00+00:00,5,12,-7,No Signal,18540.62109375
2024-06-03 19:30:00+00:00,5,15,-10,No Signal,18601.302734375
2024-06-04 13:30:00+00:00,0,17,-17,No Signal,18568.619140625
2024-06-04 14:30:00+00:00,2,19,-17,No Signal,18554.5
2024-06-04 15:30:00+00:00,2,21,-19,No Signal,18558.216796875
2024-06-04 16:30:00+00:00,3,22,-19,No Signal,18589.2734375
2024-06-04 17:30:00+00:00,1,30,-29,No Signal,18681.208984375
2024-06-04 18:30:00+00:00,2,17,-15,No Signal,18620.060546875
2024-06-04 19:30:00+00:00,10,13,-3,No Signal,18651.33984375
2024-06-05 13:30:00+00:00,5,13,-8,No Signal,18840.66015625
2024-06-05 14:30:00+00:00,2,21,-19,No Signal,18915.087890625
2024-06-05 15:30:00+00:00,1,42,-41,No Signal,18925.556640625
2024-06-05 16:30:00+00:00,1,41,-40,No Signal,18948.8203125
2024-06-05 17:30:00+00:00,2,40,-38,No Signal,18979.83984375
2024-06-05 18:30:00+00:00,2,35,-33,No Signal,18987.47265625
2024-06-05 19:30:00+00:00,3,31,-28,No Signal,19033.08203125
2024-06-06 13:30:00+00:00,4,36,-32,No Signal,19037.623046875
2024-06-06 14:30:00+00:00,1,40,-39,No Signal,19023.5859375
2024-06-06 15:30:00+00:00,2,47,-45,No Signal,19010.392578125
2024-06-06 16:30:00+00:00,3,46,-43,No Signal,19035.494140625
2024-06-06 17:30:00+00:00,4,31,-27,No Signal,19008.064453125
2024-06-06 18:30:00+00:00,4,36,-32,No Signal,19021.36328125
2024-06-06 19:30:00+00:00,4,30,-26,No Signal,19017.76953125
2024-06-07 13:30:00+00:00,5,20,-15,No Signal,19003.65234375
2024-06-07 14:30:00+00:00,11,14,-3,No Signal,19025.611328125
2024-06-07 15:30:00+00:00,11,18,-7,No Signal,19075.546875
2024-06-07 16:30:00+00:00,7,13,-6,No Signal,19087.828125
2024-06-07 17:30:00+00:00,11,10,1,No Signal,19009.34765625
2024-06-07 18:30:00+00:00,12,11,1,No Signal,19011.2734375
2024-06-07 19:30:00+00:00,16,5,11,Long,19000.05078125
2024-06-10 13:30:00+00:00,19,9,10,No Signal,19001.564453125
2024-06-10 14:30:00+00:00,16,10,6,No Signal,19055.064453125
2024-06-10 15:30:00+00:00,15,10,5,No Signal,19071.06640625
2024-06-10 16:30:00+00:00,20,8,12,No Signal,19029.8125
2024-06-10 17:30:00+00:00,10,10,0,No Signal,19016.326171875
2024-06-10 18:30:00+00:00,9,10,-1,No Signal,19078.525390625
2024-06-10 19:30:00+00:00,7,10,-3,No Signal,19075.720703125
2024-06-11 13:30:00+00:00,18,8,10,No Signal,19054.94921875
2024-06-11 14:30:00+00:00,16,11,5,No Signal,19087.39453125
2024-06-11 15:30:00+00:00,20,7,13,No Signal,19065.421875
2024-06-11 16:30:00+00:00,16,8,8,No Signal,19087.330078125
2024-06-11 17:30:00+00:00,9,17,-8,No Signal,19178.25390625
2024-06-11 18:30:00+00:00,9,15,-6,No Signal,19160.6875
2024-06-11 19:30:00+00:00,8,20,-12,Short,19210.5546875
2024-06-12 13:30:00+00:00,6,41,-35,No Signal,19510.458984375
2024-06-12 14:30:00+00:00,5,32,-27,No Signal,19501.669921875
2024-06-12 15:30:00+00:00,8,26,-18,No Signal,19469.939453125
2024-06-12 16:30:00+00:00,7,30,-23,No Signal,19493.609375
2024-06-12 17:30:00+00:00,10,24,-14,No Signal,19495.8203125
2024-06-12 18:30:00+00:00,12,17,-5,No Signal,19433.697265625
2024-06-12 19:30:00+00:00,8,22,-14,No Signal,19465.853515625
2024-06-13 13:30:00+00:00,7,23,-16,No Signal,19544.349609375
2024-06-13 14:30:00+00:00,7,21,-14,No Signal,19550.83984375
2024-06-13 15:30:00+00:00,7,13,-6,No Signal,19479.978515625
2024-06-13 16:30:00+00:00,8,16,-8,No Signal,19545.8515625
2024-06-13 17:30:00+00:00,10,12,-2,No Signal,19559.505859375
2024-06-13 18:30:00+00:00,10,16,-6,No Signal,19575.88671875
2024-06-13 19:30:00+00:00,11,16,-5,No Signal,19572.7734375
2024-06-14 13:30:00+00:00,24,4,20,Long,19606.373046875
2024-06-14 14:30:00+00:00,21,6,15,No Signal,19596.138671875
2024-06-14 15:30:00+00:00,17,4,13,No Signal,19588.078125
2024-06-14 16:30:00+00:00,17,6,11,No Signal,19639.84765625
2024-06-14 17:30:00+00:00,18,4,14,No Signal,19635.814453125
2024-06-14 18:30:00+00:00,12,7,5,No Signal,19650.138671875
2024-06-14 19:30:00+00:00,15,5,10,No Signal,19663.341796875
2024-06-17 13:30:00+00:00,16,12,4,No Signal,19667.24609375
2024-06-17 14:30:00+00:00,14,11,3,No Signal,19729.447265625
2024-06-17 15:30:00+00:00,12,22,-10,Short,19796.294921875
2024-06-17 16:30:00+00:00,15,21,-6,No Signal,19868.259765625
2024-06-17 17:30:00+00:00,9,27,-18,No Signal,19947.810546875
2024-06-17 18:30:00+00:00,10,27,-17,No Signal,19970.01953125
2024-06-17 19:30:00+00:00,8,25,-17,No Signal,19904.1953125
2024-06-18 13:30:00+00:00,10,32,-22,No Signal,19895.34765625
2024-06-18 14:30:00+00:00,7,30,-23,No Signal,19868.578125
2024-06-18 15:30:00+00:00,8,31,-23,No Signal,19888.37890625
2024-06-18 16:30:00+00:00,12,29,-17,No Signal,19927.607421875
2024-06-18 17:30:00+00:00,11,29,-18,No Signal,19898.93359375
2024-06-18 18:30:00+00:00,13,28,-15,No Signal,19906.302734375
2024-06-18 19:30:00+00:00,13,29,-16,No Signal,19906.615234375
2024-06-20 13:30:00+00:00,8,26,-18,No Signal,19887.380859375
2024-06-20 14:30:00+00:00,6,23,-17,No Signal,19910.314453125
2024-06-20 15:30:00+00:00,7,12,-5,No Signal,19787.314453125
2024-06-20 16:30:00+00:00,8,11,-3,No Signal,19731.54296875
2024-06-20 17:30:00+00:00,9,7,2,No Signal,19793.37890625
2024-06-20 18:30:00+00:00,11,7,4,No Signal,19748.859375
2024-06-20 19:30:00+00:00,10,10,0,No Signal,19753.068359375
2024-06-21 13:30:00+00:00,16,14,2,No Signal,19697.751953125
2024-06-21 14:30:00+00:00,15,16,-1,No Signal,19728.634765625
2024-06-21 15:30:00+00:00,17,14,3,No Signal,19773.451171875
2024-06-21 16:30:00+00:00,19,16,3,No Signal,19707.943359375
2024-06-21 17:30:00+00:00,15,18,-3,No Signal,19728.435546875
2024-06-21 18:30:00+00:00,21,19,2,No Signal,19723.556640625
2024-06-21 19:30:00+00:00,14,17,-3,No Signal,19704.861328125
2024-06-24 13:30:00+00:00,15,20,-5,No Signal,19619.556640625
2024-06-24 14:30:00+00:00,15,20,-5,No Signal,19638.3046875
2024-06-24 15:30:00+00:00,14,21,-7,No Signal,19630.494140625
2024-06-24 16:30:00+00:00,11,13,-2,No Signal,19551.083984375
2024-06-24 17:30:00+00:00,16,13,3,No Signal,19512.64453125
2024-06-24 18:30:00+00:00,11,12,-1,No Signal,19562.6875
2024-06-24 19:30:00+00:00,15,9,6,No Signal,19477.427734375
2024-06-25 13:30:00+00:00,10,13,-3,No Signal,19613.62109375
2024-06-25 14:30:00+00:00,10,15,-5,No Signal,19665.759765625
2024-06-25 15:30:00+00:00,12,13,-1,No Signal,19656.056640625
2024-06-25 16:30:00+00:00,13,10,3,No Signal,19629.720703125
2024-06-25 17:30:00+00:00,10,10,0,No Signal,19695.033203125
2024-06-25 18:30:00+00:00,12,11,1,No Signal,19711.88671875
2024-06-25 19:30:00+00:00,13,10,3,No Signal,19706.341796875
2024-06-26 13:30:00+00:00,17,9,8,No Signal,19695.54296875
2024-06-26 14:30:00+00:00,19,9,10,Long,19695.58203125
2024-06-26 15:30:00+00:00,18,8,10,No Signal,19741.734375
2024-06-26 16:30:00+00:00,16,14,2,No Signal,19699.166015625
2024-06-26 17:30:00+00:00,17,17,0,No Signal,19709.861328125
2024-06-26 18:30:00+00:00,18,14,4,No Signal,19700.390625
2024-06-26 19:30:00+00:00,13,22,-9,No Signal,19748.064453125
2024-06-27 13:30:00+00:00,16,17,-1,No Signal,19820.720703125
2024-06-27 14:30:00+00:00,16,14,2,No Signal,19737.2734375
2024-06-27 15:30:00+00:00,17,13,4,No Signal,19774.568359375
2024-06-27 16:30:00+00:00,14,16,-2,No Signal,19795.958984375
2024-06-27 17:30:00+00:00,17,12,5,No Signal,19756.1484375
2024-06-27 18:30:00+00:00,15,11,4,No Signal,19795.20703125
2024-06-27 19:30:00+00:00,18,14,4,No Signal,19785.818359375
2024-06-28 13:30:00+00:00,6,24,-18,Short,19968.46875
2024-06-28 14:30:00+00:00,7,17,-10,No Signal,19854.33203125
2024-06-28 15:30:00+00:00,10,13,-3,No Signal,19822.611328125
2024-06-28 16:30:00+00:00,9,12,-3,No Signal,19803.876953125
2024-06-28 17:30:00+00:00,11,9,2,No Signal,19769.044921875
2024-06-28 18:30:00+00:00,9,12,-3,No Signal,19745.873046875
2024-06-28 19:30:00+00:00,8,12,-4,No Signal,19673.001953125
2024-07-01 13:30:00+00:00,18,6,12,Long,19691.541015625
2024-07-01 14:30:00+00:00,22,6,16,No Signal,19710.22265625
2024-07-01 15:30:00+00:00,22,9,13,No Signal,19773.87890625
2024-07-01 16:30:00+00:00,23,8,15,No Signal,19765.328125
2024-07-01 17:30:00+00:00,18,7,11,No Signal,19765.09375
2024-07-01 18:30:00+00:00,28,7,21,No Signal,19765.52734375
2024-07-01 19:30:00+00:00,22,6,16,No Signal,19807.037109375
2024-07-02 13:30:00+00:00,30,3,27,No Signal,19816.982421875
2024-07-02 14:30:00+00:00,15,6,9,No Signal,19880.083984375
2024-07-02 15:30:00+00:00,15,5,10,No Signal,19864.9921875
2024-07-02 16:30:00+00:00,14,6,8,No Signal,19932.919921875
2024-07-02 17:30:00+00:00,12,9,3,No Signal,19980.19140625
2024-07-02 18:30:00+00:00,9,14,-5,No Signal,19982.572265625
2024-07-02 19:30:00+00:00,6,18,-12,Short,20013.033203125
2024-07-03 13:30:00+00:00,8,30,-22,No Signal,20026.220703125
2024-07-03 14:30:00+00:00,8,34,-26,No Signal,20110.5859375
2024-07-03 15:30:00+00:00,5,31,-26,No Signal,20182.44921875
2024-07-05 13:30:00+00:00,6,23,-17,No Signal,20286.5546875
2024-07-05 14:30:00+00:00,5,30,-25,No Signal,20325.888671875
2024-07-05 15:30:00+00:00,3,37,-34,No Signal,20380.029296875
2024-07-05 16:30:00+00:00,6,35,-29,No Signal,20378.888671875
2024-07-05 17:30:00+00:00,3,35,-32,No Signal,20367.98046875
2024-07-05 18:30:00+00:00,4,34,-30,No Signal,20390.865234375
2024-07-05 19:30:00+00:00,1,36,-35,No Signal,20389.236328125
2024-07-08 13:30:00+00:00,4,29,-25,No Signal,20398.259765625
2024-07-08 14:30:00+00:00,8,27,-19,No Signal,20433.421875
2024-07-08 15:30:00+00:00,9,18,-9,No Signal,20395.7109375
2024-07-08 16:30:00+00:00,9,22,-13,No Signal,20423.544921875
2024-07-08 17:30:00+00:00,10,25,-15,No Signal,20425.021484375
2024-07-08 18:30:00+00:00,6,17,-11,No Signal,20395.921875
2024-07-08 19:30:00+00:00,11,20,-9,No Signal,20438.3671875
2024-07-09 13:30:00+00:00,10,19,-9,No Signal,20476.73046875
2024-07-09 14:30:00+00:00,15,17,-2,No Signal,20460.009765625
2024-07-09 15:30:00+00:00,18,14,4,No Signal,20476.162109375
2024-07-09 16:30:00+00:00,18,12,6,No Signal,20408.908203125
2024-07-09 17:30:00+00:00,17,14,3,No Signal,20427.853515625
2024-07-09 18:30:00+00:00,21,13,8,No Signal,20438.048828125
2024-07-09 19:30:00+00:00,25,9,16,Long,20454.67578125
2024-07-10 13:30:00+00:00,13,11,2,No Signal,20546.185546875
2024-07-10 14:30:00+00:00,15,13,2,No Signal,20527.3125
2024-07-10 15:30:00+00:00,11,16,-5,No Signal,20584.70703125
2024-07-10 16:30:00+00:00,8,16,-8,No Signal,20625.515625
2024-07-10 17:30:00+00:00,10,17,-7,No Signal,20639.41015625
2024-07-10 18:30:00+00:00,8,20,-12,Short,20643.123046875
2024-07-10 19:30:00+00:00,8,22,-14,No Signal,20673.421875
2024-07-11 13:30:00+00:00,6,29,-23,No Signal,20472.47265625
2024-07-11 14:30:00+00:00,9,28,-19,No Signal,20318.30859375
2024-07-11 15:30:00+00:00,11,23,-12,No Signal,20294.0078125
2024-07-11 16:30:00+00:00,10,23,-13,No Signal,20267.75
2024-07-11 17:30:00+00:00,16,22,-6,No Signal,20200.2890625
2024-07-11 18:30:00+00:00,15,23,-8,No Signal,20223.119140625
2024-07-11 19:30:00+00:00,13,25,-12,No Signal,20217.05859375
2024-07-12 13:30:00+00:00,8,34,-26,No Signal,20343.099609375
2024-07-12 14:30:00+00:00,4,42,-38,No Signal,20443.5703125
2024-07-12 15:30:00+00:00,7,31,-24,No Signal,20380.9453125
2024-07-12 16:30:00+00:00,5,34,-29,No Signal,20456.939453125
2024-07-12 17:30:00+00:00,5,41,-36,No Signal,20491.64453125
2024-07-12 18:30:00+00:00,6,34,-28,No Signal,20468.818359375
2024-07-12 19:30:00+00:00,9,26,-17,No Signal,20332.220703125
2024-07-15 13:30:00+00:00,7,10,-3,No Signal,20477.99609375
2024-07-15 14:30:00+00:00,6,16,-10,No Signal,20529.220703125
2024-07-15 15:30:00+00:00,6,17,-11,No Signal,20456.234375
2024-07-15 16:30:00+00:00,6,18,-12,No Signal,20402.978515625
2024-07-15 17:30:00+00:00,7,23,-16,No Signal,20394.091796875
2024-07-15 18:30:00+00:00,6,21,-15,No Signal,20416.947265625
2024-07-15 19:30:00+00:00,6,18,-12,No Signal,20392.841796875
2024-07-16 13:30:00+00:00,11,17,-6,No Signal,20319.5078125
2024-07-16 14:30:00+00:00,15,18,-3,No Signal,20355.939453125
2024-07-16 15:30:00+00:00,13,18,-5,No Signal,20285.9609375
2024-07-16 16:30:00+00:00,17,19,-2,No Signal,20311.66796875
2024-07-16 17:30:00+00:00,15,19,-4,No Signal,20332.455078125
2024-07-16 18:30:00+00:00,15,19,-4,No Signal,20374.583984375
2024-07-16 19:30:00+00:00,9,28,-19,No Signal,20397.21484375
2024-07-17 13:30:00+00:00,28,33,-5,No Signal,19936.072265625
2024-07-17 14:30:00+00:00,29,20,9,No Signal,19929.83984375
2024-07-17 15:30:00+00:00,30,19,11,Long,19838.615234375
2024-07-17 16:30:00+00:00,28,20,8,No Signal,19851.134765625
2024-07-17 17:30:00+00:00,24,18,6,No Signal,19864.57421875
2024-07-17 18:30:00+00:00,27,17,10,No Signal,19860.5703125
2024-07-17 19:30:00+00:00,27,19,8,No Signal,19801.06640625
2024-07-18 13:30:00+00:00,26,16,10,No Signal,19857.08984375
2024-07-18 14:30:00+00:00,34,16,18,No Signal,19632.158203125
2024-07-18 15:30:00+00:00,36,14,22,No Signal,19644.953125
2024-07-18 16:30:00+00:00,32,13,19,No Signal,19713.189453125
2024-07-18 17:30:00+00:00,42,6,36,No Signal,19663.96484375
2024-07-18 18:30:00+00:00,45,5,40,No Signal,19635.005859375
2024-07-18 19:30:00+00:00,43,3,40,No Signal,19706.314453125
2024-07-19 13:30:00+00:00,39,1,38,No Signal,19629.15625
2024-07-19 14:30:00+00:00,46,2,44,No Signal,19571.15625
2024-07-19 15:30:00+00:00,30,1,29,No Signal,19568.84765625
2024-07-19 16:30:00+00:00,35,2,33,No Signal,19511.59765625
2024-07-19 17:30:00+00:00,44,1,43,No Signal,19517.228515625
2024-07-19 18:30:00+00:00,28,3,25,No Signal,19588.103515625
2024-07-19 19:30:00+00:00,30,3,27,No Signal,19523.5703125
2024-07-22 13:30:00+00:00,26,2,24,No Signal,19775.84765625
2024-07-22 14:30:00+00:00,23,3,20,No Signal,19663.548828125
2024-07-22 15:30:00+00:00,19,6,13,No Signal,19713.185546875
2024-07-22 16:30:00+00:00,14,6,8,No Signal,19801.228515625
2024-07-22 17:30:00+00:00,10,9,1,No Signal,19842.87890625
2024-07-22 18:30:00+00:00,5,16,-11,Short,19817.048828125
2024-07-22 19:30:00+00:00,7,14,-7,No Signal,19831.228515625
2024-07-23 13:30:00+00:00,6,16,-10,No Signal,19843.755859375
2024-07-23 14:30:00+00:00,7,24,-17,No Signal,19886.18359375
2024-07-23 15:30:00+00:00,6,7,-1,No Signal,19795.298828125
2024-07-23 16:30:00+00:00,7,12,-5,No Signal,19788.013671875
2024-07-23 17:30:00+00:00,6,12,-6,No Signal,19786.181640625
2024-07-23 18:30:00+00:00,6,9,-3,No Signal,19814.71484375
2024-07-23 19:30:00+00:00,7,9,-2,No Signal,19753.890625
2024-07-24 13:30:00+00:00,23,6,17,Long,19324.240234375
2024-07-24 14:30:00+00:00,20,3,17,No Signal,19234.35546875
2024-07-24 15:30:00+00:00,30,4,26,No Signal,19167.07421875
2024-07-24 16:30:00+00:00,41,3,38,No Signal,19187.103515625
2024-07-24 17:30:00+00:00,41,2,39,No Signal,19127.197265625
2024-07-24 18:30:00+00:00,46,2,44,No Signal,19053.826171875
2024-07-24 19:30:00+00:00,47,4,43,No Signal,19037.08984375
2024-07-25 13:30:00+00:00,46,17,29,No Signal,18924.04296875
2024-07-25 14:30:00+00:00,42,11,31,No Signal,19044.001953125
2024-07-25 15:30:00+00:00,24,13,11,No Signal,19179.44921875
2024-07-25 16:30:00+00:00,27,12,15,No Signal,19106.669921875
2024-07-25 17:30:00+00:00,31,7,24,No Signal,19061.693359375
2024-07-25 18:30:00+00:00,34,8,26,No Signal,19056.9140625
2024-07-25 19:30:00+00:00,42,6,36,No Signal,18828.611328125
2024-07-26 13:30:00+00:00,15,11,4,No Signal,18995.63671875
2024-07-26 14:30:00+00:00,12,7,5,No Signal,18960.365234375
2024-07-26 15:30:00+00:00,9,7,2,No Signal,19081.0
2024-07-26 16:30:00+00:00,8,10,-2,No Signal,19137.51171875
2024-07-26 17:30:00+00:00,8,6,2,No Signal,19029.83203125
2024-07-26 18:30:00+00:00,7,8,-1,No Signal,19029.818359375
2024-07-26 19:30:00+00:00,5,12,-7,No Signal,19023.921875
2024-07-29 13:30:00+00:00,9,7,2,No Signal,19145.15625
2024-07-29 14:30:00+00:00,7,8,-1,No Signal,19042.552734375
2024-07-29 15:30:00+00:00,7,6,1,No Signal,19153.765625
2024-07-29 16:30:00+00:00,6,7,-1,No Signal,19120.8125
2024-07-29 17:30:00+00:00,7,9,-2,No Signal,19072.8828125
2024-07-29 18:30:00+00:00,6,12,-6,No Signal,19092.01171875
2024-07-29 19:30:00+00:00,4,21,-17,Short,19058.791015625
2024-07-30 13:30:00+00:00,3,14,-11,No Signal,19024.771484375
2024-07-30 14:30:00+00:00,5,15,-10,No Signal,18883.99609375
2024-07-30 15:30:00+00:00,18,13,5,No Signal,18793.623046875
2024-07-30 16:30:00+00:00,24,10,14,Long,18763.779296875
2024-07-30 17:30:00+00:00,16,15,1,No Signal,18829.099609375
2024-07-30 18:30:00+00:00,17,15,2,No Signal,18791.25390625
2024-07-30 19:30:00+00:00,16,19,-3,No Signal,18789.5390625
2024-07-31 13:30:00+00:00,4,24,-20,Short,19286.71484375
2024-07-31 14:30:00+00:00,4,24,-20,No Signal,19341.322265625
2024-07-31 15:30:00+00:00,6,13,-7,No Signal,19303.56640625
2024-07-31 16:30:00+00:00,5,17,-12,No Signal,19296.439453125
2024-07-31 17:30:00+00:00,3,18,-15,No Signal,19329.337890625
2024-07-31 18:30:00+00:00,5,13,-8,No Signal,19294.916015625
2024-07-31 19:30:00+00:00,4,10,-6,No Signal,19360.56640625
2024-08-01 13:30:00+00:00,6,7,-1,No Signal,19315.052734375
2024-08-01 14:30:00+00:00,8,9,-1,No Signal,19127.845703125
2024-08-01 15:30:00+00:00,9,7,2,No Signal,19018.736328125
2024-08-01 16:30:00+00:00,10,9,1,No Signal,18882.783203125
2024-08-01 17:30:00+00:00,13,7,6,No Signal,18784.03515625
2024-08-01 18:30:00+00:00,12,6,6,No Signal,18840.013671875
2024-08-01 19:30:00+00:00,13,9,4,No Signal,18882.05859375
2024-08-02 13:30:00+00:00,57,5,52,Long,18373.392578125
2024-08-02 14:30:00+00:00,64,3,61,No Signal,18359.693359375
2024-08-02 15:30:00+00:00,49,5,44,No Signal,18470.984375
2024-08-02 16:30:00+00:00,54,4,50,No Signal,18362.47265625
2024-08-02 17:30:00+00:00,50,5,45,No Signal,18427.58203125
2024-08-02 18:30:00+00:00,47,6,41,No Signal,18426.357421875
2024-08-02 19:30:00+00:00,47,6,41,No Signal,18436.212890625
2024-08-05 13:30:00+00:00,65,0,65,No Signal,17755.6015625
2024-08-05 14:30:00+00:00,47,2,45,No Signal,17993.302734375
2024-08-05 15:30:00+00:00,24,2,22,No Signal,18166.818359375
2024-08-05 16:30:00+00:00,25,2,23,No Signal,17982.25390625
2024-08-05 17:30:00+00:00,24,1,23,No Signal,17926.005859375
2024-08-05 18:30:00+00:00,34,1,33,No Signal,17865.1796875
2024-08-05 19:30:00+00:00,36,1,35,No Signal,17894.3671875
2024-08-06 13:30:00+00:00,11,4,7,No Signal,18064.296875
2024-08-06 14:30:00+00:00,7,3,4,No Signal,18084.22265625
2024-08-06 15:30:00+00:00,4,3,1,No Signal,18223.916015625
2024-08-06 16:30:00+00:00,7,4,3,No Signal,18308.017578125
2024-08-06 17:30:00+00:00,4,3,1,No Signal,18344.384765625
2024-08-06 18:30:00+00:00,12,3,9,No Signal,18229.9375
2024-08-06 19:30:00+00:00,14,1,13,No Signal,18071.6875
2024-08-07 13:30:00+00:00,1,30,-29,Short,18328.884765625
2024-08-07 14:30:00+00:00,0,19,-19,No Signal,18360.447265625
2024-08-07 15:30:00+00:00,1,8,-7,No Signal,18274.228515625
2024-08-07 16:30:00+00:00,1,9,-8,No Signal,18094.79296875
2024-08-07 17:30:00+00:00,1,7,-6,No Signal,17976.15234375
2024-08-07 18:30:00+00:00,2,10,-8,No Signal,17985.0625
2024-08-07 19:30:00+00:00,2,3,-1,No Signal,17864.775390625
2024-08-08 13:30:00+00:00,2,10,-8,No Signal,18270.69140625
2024-08-08 14:30:00+00:00,4,8,-4,No Signal,18286.267578125
2024-08-08 15:30:00+00:00,4,5,-1,No Signal,18331.8125
2024-08-08 16:30:00+00:00,3,6,-3,No Signal,18385.779296875
2024-08-08 17:30:00+00:00,2,5,-3,No Signal,18405.17578125
2024-08-08 18:30:00+00:00,3,7,-4,No Signal,18339.16796875
2024-08-08 19:30:00+00:00,2,12,-10,No Signal,18413.369140625
2024-08-09 13:30:00+00:00,6,4,2,No Signal,18400.427734375
2024-08-09 14:30:00+00:00,10,4,6,No Signal,18414.453125
2024-08-09 15:30:00+00:00,8,4,4,No Signal,18383.412109375
2024-08-09 16:30:00+00:00,3,21,-18,No Signal,18543.78125
2024-08-09 17:30:00+00:00,3,31,-28,No Signal,18491.6171875
2024-08-09 18:30:00+00:00,2,30,-28,No Signal,18508.861328125
2024-08-09 19:30:00+00:00,2,43,-41,No Signal,18513.896484375
2024-08-12 13:30:00+00:00,4,18,-14,No Signal,18592.88671875
2024-08-12 14:30:00+00:00,7,12,-5,No Signal,18529.84375
2024-08-12 15:30:00+00:00,4,15,-11,No Signal,18595.669921875
2024-08-12 16:30:00+00:00,7,11,-4,No Signal,18555.5703125
2024-08-12 17:30:00+00:00,8,5,3,No Signal,18527.076171875
2024-08-12 18:30:00+00:00,4,9,-5,No Signal,18523.37109375
2024-08-12 19:30:00+00:00,8,7,1,No Signal,18543.478515625
2024-08-13 13:30:00+00:00,4,23,-19,No Signal,18803.998046875
2024-08-13 14:30:00+00:00,5,29,-24,No Signal,18869.166015625
2024-08-13 15:30:00+00:00,3,37,-34,No Signal,18913.521484375
2024-08-13 16:30:00+00:00,2,26,-24,No Signal,18967.775390625
2024-08-13 17:30:00+00:00,0,32,-32,No Signal,18969.068359375
2024-08-13 18:30:00+00:00,1,35,-34,No Signal,18962.138671875
2024-08-13 19:30:00+00:00,0,31,-31,No Signal,19006.2109375
2024-08-14 13:30:00+00:00,3,25,-22,No Signal,18917.2265625
2024-08-14 14:30:00+00:00,2,37,-35,No Signal,19011.0859375
2024-08-14 15:30:00+00:00,3,30,-27,No Signal,18979.513671875
2024-08-14 16:30:00+00:00,3,38,-35,No Signal,18987.970703125
2024-08-14 17:30:00+00:00,2,44,-42,No Signal,18992.736328125
2024-08-14 18:30:00+00:00,2,42,-40,No Signal,18961.5234375
2024-08-14 19:30:00+00:00,1,38,-37,No Signal,19021.32421875
2024-08-15 13:30:00+00:00,0,54,-54,No Signal,19377.5859375
2024-08-15 14:30:00+00:00,0,51,-51,No Signal,19403.25
2024-08-15 15:30:00+00:00,0,48,-48,No Signal,19464.595703125
2024-08-15 16:30:00+00:00,1,40,-39,No Signal,19443.3203125
2024-08-15 17:30:00+00:00,0,40,-40,No Signal,19482.916015625
2024-08-15 18:30:00+00:00,1,41,-40,No Signal,19482.994140625
2024-08-15 19:30:00+00:00,2,39,-37,No Signal,19488.712890625
2024-08-16 13:30:00+00:00,4,45,-41,No Signal,19478.494140625
2024-08-16 14:30:00+00:00,1,39,-38,No Signal,19439.185546875
2024-08-16 15:30:00+00:00,1,45,-44,No Signal,19521.140625
2024-08-16 16:30:00+00:00,1,49,-48,No Signal,19543.373046875
2024-08-16 17:30:00+00:00,1,48,-47,No Signal,19518.47265625
2024-08-16 18:30:00+00:00,1,49,-48,No Signal,19508.00390625
2024-08-16 19:30:00+00:00,0,46,-46,No Signal,19508.80859375
2024-08-19 13:30:00+00:00,2,27,-25,No Signal,19521.91015625
2024-08-19 14:30:00+00:00,3,27,-24,No Signal,19565.876953125
2024-08-19 15:30:00+00:00,8,26,-18,No Signal,19571.736328125
2024-08-19 16:30:00+00:00,5,26,-21,No Signal,19602.5390625
2024-08-19 17:30:00+00:00,4,22,-18,No Signal,19648.6875
2024-08-19 18:30:00+00:00,5,24,-19,No Signal,19690.416015625
2024-08-19 19:30:00+00:00,2,32,-30,No Signal,19763.912109375
2024-08-20 13:30:00+00:00,0,36,-36,No Signal,19732.525390625
2024-08-20 14:30:00+00:00,1,28,-27,No Signal,19706.03515625
2024-08-20 15:30:00+00:00,0,29,-29,No Signal,19719.52734375
2024-08-20 16:30:00+00:00,1,23,-22,No Signal,19698.068359375
2024-08-20 17:30:00+00:00,1,29,-28,No Signal,19759.0546875
2024-08-20 18:30:00+00:00,2,26,-24,No Signal,19733.1171875
2024-08-20 19:30:00+00:00,4,24,-20,No Signal,19716.67578125
2024-08-21 13:30:00+00:00,4,27,-23,No Signal,19791.9296875
2024-08-21 14:30:00+00:00,6,24,-18,No Signal,19778.287109375
2024-08-21 15:30:00+00:00,5,24,-19,No Signal,19750.34765625
2024-08-21 16:30:00+00:00,7,23,-16,No Signal,19769.791015625
2024-08-21 17:30:00+00:00,4,25,-21,No Signal,19839.564453125
2024-08-21 18:30:00+00:00,5,14,-9,No Signal,19781.587890625
2024-08-21 19:30:00+00:00,5,14,-9,No Signal,19822.583984375
2024-08-22 13:30:00+00:00,9,22,-13,No Signal,19830.271484375
2024-08-22 14:30:00+00:00,11,11,0,No Signal,19725.068359375
2024-08-22 15:30:00+00:00,8,16,-8,No Signal,19727.240234375
2024-08-22 16:30:00+00:00,12,10,2,No Signal,19628.515625
2024-08-22 17:30:00+00:00,16,9,7,No Signal,19574.71875
2024-08-22 18:30:00+00:00,21,9,12,Long,19496.333984375
2024-08-22 19:30:00+00:00,19,9,10,No Signal,19495.25
2024-08-23 13:30:00+00:00,9,13,-4,No Signal,19807.421875
2024-08-23 14:30:00+00:00,10,12,-2,No Signal,19693.42578125
2024-08-23 15:30:00+00:00,16,10,6,No Signal,19582.634765625
2024-08-23 16:30:00+00:00,15,10,5,No Signal,19649.419921875
2024-08-23 17:30:00+00:00,15,8,7,No Signal,19674.818359375
2024-08-23 18:30:00+00:00,10,9,1,No Signal,19724.046875
2024-08-23 19:30:00+00:00,11,9,2,No Signal,19721.08984375
2024-08-26 13:30:00+00:00,10,17,-7,No Signal,19541.533203125
2024-08-26 14:30:00+00:00,8,16,-8,No Signal,19537.064453125
2024-08-26 15:30:00+00:00,7,14,-7,No Signal,19540.26171875
2024-08-26 16:30:00+00:00,8,25,-17,Short,19522.998046875
2024-08-26 17:30:00+00:00,6,16,-10,No Signal,19504.7734375
2024-08-26 18:30:00+00:00,4,16,-12,No Signal,19515.638671875
2024-08-26 19:30:00+00:00,5,16,-11,No Signal,19517.671875
2024-08-27 13:30:00+00:00,24,10,14,Long,19553.111328125
2024-08-27 14:30:00+00:00,22,11,11,No Signal,19563.67578125
2024-08-27 15:30:00+00:00,15,18,-3,No Signal,19551.849609375
2024-08-27 16:30:00+00:00,15,17,-2,No Signal,19597.59375
2024-08-27 17:30:00+00:00,13,16,-3,No Signal,19592.46875
2024-08-27 18:30:00+00:00,19,13,6,No Signal,19578.28515625
2024-08-27 19:30:00+00:00,16,15,1,No Signal,19584.595703125
2024-08-28 13:30:00+00:00,17,10,7,No Signal,19511.05078125
2024-08-28 14:30:00+00:00,27,5,22,No Signal,19319.85546875
2024-08-28 15:30:00+00:00,29,3,26,No Signal,19330.1953125
2024-08-28 16:30:00+00:00,25,2,23,No Signal,19362.634765625
2024-08-28 17:30:00+00:00,26,2,24,No Signal,19263.521484375
2024-08-28 18:30:00+00:00,17,4,13,No Signal,19388.515625
2024-08-28 19:30:00+00:00,20,3,17,No Signal,19351.25390625
2024-08-29 13:30:00+00:00,7,6,1,No Signal,19532.78515625
2024-08-29 14:30:00+00:00,6,7,-1,No Signal,19563.16015625
2024-08-29 15:30:00+00:00,8,10,-2,No Signal,19601.880859375
2024-08-29 16:30:00+00:00,9,8,1,No Signal,19552.890625
2024-08-29 17:30:00+00:00,9,5,4,No Signal,19439.958984375
2024-08-29 18:30:00+00:00,11,3,8,No Signal,19341.076171875
2024-08-29 19:30:00+00:00,12,2,10,No Signal,19328.296875
2024-08-30 13:30:00+00:00,7,5,2,No Signal,19494.90234375
2024-08-30 14:30:00+00:00,6,7,-1,No Signal,19416.125
2024-08-30 15:30:00+00:00,10,6,4,No Signal,19370.73046875
2024-08-30 16:30:00+00:00,9,6,3,No Signal,19415.375
2024-08-30 17:30:00+00:00,6,11,-5,No Signal,19426.357421875
2024-08-30 18:30:00+00:00,7,11,-4,No Signal,19507.775390625
2024-08-30 19:30:00+00:00,5,14,-9,No Signal,19571.95703125
2024-09-03 13:30:00+00:00,13,4,9,No Signal,19270.779296875
2024-09-03 14:30:00+00:00,19,9,10,No Signal,19150.6171875
2024-09-03 15:30:00+00:00,29,8,21,No Signal,19119.00390625
2024-09-03 16:30:00+00:00,30,9,21,No Signal,19124.287109375
2024-09-03 17:30:00+00:00,32,8,24,No Signal,18991.73046875
2024-09-03 18:30:00+00:00,31,7,24,No Signal,18985.98828125
2024-09-03 19:30:00+00:00,32,6,26,No Signal,18959.755859375
2024-09-04 13:30:00+00:00,42,7,35,No Signal,18940.1640625
2024-09-04 14:30:00+00:00,33,10,23,No Signal,18971.623046875
2024-09-04 15:30:00+00:00,31,8,23,No Signal,18998.556640625
2024-09-04 16:30:00+00:00,35,7,28,No Signal,18977.33203125
2024-09-04 17:30:00+00:00,35,7,28,No Signal,18967.5859375
2024-09-04 18:30:00+00:00,46,7,39,No Signal,18919.453125
2024-09-04 19:30:00+00:00,49,8,41,No Signal,18918.619140625
2024-09-05 13:30:00+00:00,41,4,37,No Signal,19064.2578125
2024-09-05 14:30:00+00:00,56,1,55,No Signal,18832.857421875
2024-09-05 15:30:00+00:00,38,1,37,No Signal,18900.12109375
2024-09-05 16:30:00+00:00,39,1,38,No Signal,18852.845703125
2024-09-05 17:30:00+00:00,15,2,13,No Signal,18949.0078125
2024-09-05 18:30:00+00:00,19,2,17,No Signal,18922.30078125
2024-09-05 19:30:00+00:00,16,4,12,No Signal,18927.8515625
2024-09-06 13:30:00+00:00,31,0,31,No Signal,18617.03515625
2024-09-06 14:30:00+00:00,43,0,43,No Signal,18471.6328125
2024-09-06 15:30:00+00:00,49,0,49,No Signal,18418.38671875
2024-09-06 16:30:00+00:00,39,0,39,No Signal,18462.103515625
2024-09-06 17:30:00+00:00,39,0,39,No Signal,18423.978515625
2024-09-06 18:30:00+00:00,28,0,28,No Signal,18481.5546875
2024-09-06 19:30:00+00:00,34,1,33,No Signal,18421.3046875
2024-09-09 13:30:00+00:00,18,5,13,No Signal,18588.919921875
2024-09-09 14:30:00+00:00,10,7,3,No Signal,18532.98046875
2024-09-09 15:30:00+00:00,9,10,-1,No Signal,18643.56640625
2024-09-09 16:30:00+00:00,7,10,-3,No Signal,18680.697265625
2024-09-09 17:30:00+00:00,16,5,11,No Signal,18565.740234375
2024-09-09 18:30:00+00:00,11,6,5,No Signal,18611.078125
2024-09-09 19:30:00+00:00,12,5,7,No Signal,18664.126953125
2024-09-10 13:30:00+00:00,9,11,-2,No Signal,18754.31640625
2024-09-10 14:30:00+00:00,3,22,-19,Short,18746.162109375
2024-09-10 15:30:00+00:00,4,12,-8,No Signal,18614.1875
2024-09-10 16:30:00+00:00,6,15,-9,No Signal,18717.87109375
2024-09-10 17:30:00+00:00,3,17,-14,No Signal,18796.302734375
2024-09-10 18:30:00+00:00,4,19,-15,No Signal,18828.330078125
2024-09-10 19:30:00+00:00,1,21,-20,No Signal,18835.697265625
2024-09-11 13:30:00+00:00,13,10,3,No Signal,18636.154296875
2024-09-11 14:30:00+00:00,9,11,-2,No Signal,18664.693359375
2024-09-11 15:30:00+00:00,8,12,-4,No Signal,18883.90234375
2024-09-11 16:30:00+00:00,4,12,-8,No Signal,18959.328125
2024-09-11 17:30:00+00:00,3,18,-15,No Signal,19093.091796875
2024-09-11 18:30:00+00:00,2,20,-18,No Signal,19172.451171875
2024-09-11 19:30:00+00:00,2,22,-20,No Signal,19232.48828125
2024-09-12 13:30:00+00:00,3,25,-22,No Signal,19316.1796875
2024-09-12 14:30:00+00:00,5,24,-19,No Signal,19270.9921875
2024-09-12 15:30:00+00:00,4,34,-30,No Signal,19296.15234375
2024-09-12 16:30:00+00:00,4,33,-29,No Signal,19383.96484375
2024-09-12 17:30:00+00:00,1,33,-32,No Signal,19446.783203125
2024-09-12 18:30:00+00:00,2,27,-25,No Signal,19422.0703125
2024-09-12 19:30:00+00:00,2,28,-26,No Signal,19425.236328125
2024-09-13 13:30:00+00:00,2,69,-67,No Signal,19447.72265625
2024-09-13 14:30:00+00:00,2,66,-64,No Signal,19502.662109375
2024-09-13 15:30:00+00:00,3,54,-51,No Signal,19481.03125
2024-09-13 16:30:00+00:00,3,53,-50,No Signal,19543.599609375
2024-09-13 17:30:00+00:00,3,37,-34,No Signal,19497.78125
2024-09-13 18:30:00+00:00,3,33,-30,No Signal,19510.134765625
2024-09-13 19:30:00+00:00,5,31,-26,No Signal,19512.744140625
2024-09-16 13:30:00+00:00,4,31,-27,No Signal,19373.515625
2024-09-16 14:30:00+00:00,3,26,-23,No Signal,19369.78125
2024-09-16 15:30:00+00:00,7,25,-18,No Signal,19347.91015625
2024-09-16 16:30:00+00:00,7,19,-12,No Signal,19369.880859375
2024-09-16 17:30:00+00:00,6,20,-14,No Signal,19419.470703125
2024-09-16 18:30:00+00:00,7,18,-11,No Signal,19403.701171875
2024-09-16 19:30:00+00:00,5,17,-12,No Signal,19425.20703125
2024-09-17 13:30:00+00:00,7,32,-25,No Signal,19554.1015625
2024-09-17 14:30:00+00:00,10,26,-16,No Signal,19521.212890625
2024-09-17 15:30:00+00:00,13,18,-5,No Signal,19444.6953125
2024-09-17 16:30:00+00:00,13,12,1,No Signal,19432.30078125
2024-09-17 17:30:00+00:00,15,20,-5,No Signal,19413.466796875
2024-09-17 18:30:00+00:00,15,15,0,No Signal,19401.310546875
2024-09-17 19:30:00+00:00,14,17,-3,No Signal,19434.005859375
2024-09-18 13:30:00+00:00,11,16,-5,No Signal,19449.974609375
2024-09-18 14:30:00+00:00,15,16,-1,No Signal,19418.55078125
2024-09-18 15:30:00+00:00,12,16,-4,No Signal,19424.15234375
2024-09-18 16:30:00+00:00,12,17,-5,No Signal,19457.41796875
2024-09-18 17:30:00+00:00,14,21,-7,No Signal,19562.7890625
2024-09-18 18:30:00+00:00,11,19,-8,No Signal,19499.85546875
2024-09-18 19:30:00+00:00,15,5,10,Long,19346.341796875
2024-09-19 13:30:00+00:00,4,10,-6,No Signal,19880.865234375
2024-09-19 14:30:00+00:00,6,14,-8,No Signal,19888.58203125
2024-09-19 15:30:00+00:00,5,21,-16,Short,19912.8828125
2024-09-19 16:30:00+00:00,4,26,-22,No Signal,19914.76953125
2024-09-19 17:30:00+00:00,4,27,-23,No Signal,19906.189453125
2024-09-19 18:30:00+00:00,5,16,-11,No Signal,19860.443359375
2024-09-19 19:30:00+00:00,4,16,-12,No Signal,19838.939453125
2024-09-20 13:30:00+00:00,4,12,-8,No Signal,19767.208984375
2024-09-20 14:30:00+00:00,4,9,-5,No Signal,19677.9140625
2024-09-20 15:30:00+00:00,5,11,-6,No Signal,19784.189453125
2024-09-20 16:30:00+00:00,4,11,-7,No Signal,19770.201171875
2024-09-20 17:30:00+00:00,8,8,0,No Signal,19725.1640625
2024-09-20 18:30:00+00:00,7,9,-2,No Signal,19806.26953125
2024-09-20 19:30:00+00:00,4,20,-16,No Signal,19794.177734375
2024-09-23 13:30:00+00:00,18,9,9,No Signal,19870.416015625
2024-09-23 14:30:00+00:00,17,13,4,No Signal,19859.5234375
2024-09-23 15:30:00+00:00,22,10,12,Long,19839.068359375
2024-09-23 16:30:00+00:00,22,8,14,No Signal,19815.755859375
2024-09-23 17:30:00+00:00,18,8,10,No Signal,19842.11328125
2024-09-23 18:30:00+00:00,17,12,5,No Signal,19849.85546875
2024-09-23 19:30:00+00:00,17,13,4,No Signal,19851.650390625
2024-09-24 13:30:00+00:00,8,15,-7,No Signal,19769.314453125
2024-09-24 14:30:00+00:00,4,31,-27,Short,19888.921875
2024-09-24 15:30:00+00:00,6,29,-23,No Signal,19959.931640625
2024-09-24 16:30:00+00:00,6,32,-26,No Signal,19947.17578125
2024-09-24 17:30:00+00:00,5,31,-26,No Signal,19921.20703125
2024-09-24 18:30:00+00:00,8,29,-21,No Signal,19927.85546875
2024-09-24 19:30:00+00:00,7,25,-18,No Signal,19945.369140625
2024-09-25 13:30:00+00:00,9,22,-13,No Signal,20003.681640625
2024-09-25 14:30:00+00:00,14,20,-6,No Signal,19980.3203125
2024-09-25 15:30:00+00:00,15,23,-8,No Signal,19986.4921875
2024-09-25 16:30:00+00:00,15,19,-4,No Signal,19961.35546875
2024-09-25 17:30:00+00:00,14,20,-6,No Signal,19970.375
2024-09-25 18:30:00+00:00,16,22,-6,No Signal,19957.927734375
2024-09-25 19:30:00+00:00,15,19,-4,No Signal,19972.8046875
2024-09-26 13:30:00+00:00,9,25,-16,No Signal,20121.48046875
2024-09-26 14:30:00+00:00,14,15,-1,No Signal,20032.982421875
2024-09-26 15:30:00+00:00,13,16,-3,No Signal,20034.037109375
2024-09-26 16:30:00+00:00,14,16,-2,No Signal,20022.703125
2024-09-26 17:30:00+00:00,11,24,-13,No Signal,20119.24609375
2024-09-26 18:30:00+00:00,11,24,-13,No Signal,20121.65234375
2024-09-26 19:30:00+00:00,9,25,-16,No Signal,20112.958984375
2024-09-27 13:30:00+00:00,4,28,-24,No Signal,20092.568359375
2024-09-27 14:30:00+00:00,7,29,-22,No Signal,20048.82421875
2024-09-27 15:30:00+00:00,10,26,-16,No Signal,20033.755859375
2024-09-27 16:30:00+00:00,7,29,-22,No Signal,20014.60546875
2024-09-27 17:30:00+00:00,6,23,-17,No Signal,19985.1015625
2024-09-27 18:30:00+00:00,6,25,-19,No Signal,20021.0625
2024-09-27 19:30:00+00:00,8,23,-15,No Signal,20008.625
